###############
#       #######
#       #######
## #### #  ####
## #@##    ####
# $$$ $  $$####
#  # ## $  ####
#  # ##  $ ####
####  $$$ $#  #
##   ##   ....#
## #   # #.. .#
##   # # ##...#
###### $  #...#
#######   #####
###############
