############
######     #
######.*$# #
#####  ..$ #
#####$# $###
# $   # .###
# #* *  $###
#@ .. #  ###
###   ######
############
