##########
##   #  ##
## #$# $##
#       ##
#  #*# $##
#  ..*   #
####.### #
#  ..* $ #
#@ #.#  ##
# $    $##
#  ###  ##
##########
