########
####  ##
##@$. ##
##$* . #
##  .  #
# $*$* #
#   . ##
###  ###
########
