#############
###   #   ###
##  # # #  ##
#  # $.$ #  #
# #  * .  # #
#   .#*# $  #
###.$#@#$.###
#  $.###.$  #
# #  . . .# #
#  #  $  #  #
##  #$#$#  ##
###   #   ###
#############
