#################
###@   #  #######
### $  # $$  ####
###  $ $  #  ####
####$ #.#   #####
#### ##.###    ##
###  *......#  ##
###  ##.##### ###
#### ##.##  # $ #
#    $   #$   # #
# #  ##  $  #   #
# ########  #####
#        # ######
########   ######
#################
