#######
#+  ###
#$# ###
#  $  #
# $$. #
#..####
#######
