#########
#   #####
# #$#   #
# ..  # #
# #..$  #
#  #.  ##
##$ ## ##
#@$  # ##
# $    ##
#####  ##
#########
