##########
##  ###  #
##  ###  #
##$..... #
## #### ##
## #@$  ##
## #$#   #
#  # $ $ #
#     # ##
##  #   ##
#####  ###
##########
