#########
###   ###
###$  ###
#@$ .$$ #
# #. .# #
# *$.   #
###.# ###
###   ###
#########
