###########
#####  ####
### .$ ####
#    .  ###
# $.## .###
##* ##*$$ #
##  .   $@#
###  * ####
###  ######
###########
