#########
#      ##
# *$$  ##
# . **..#
##.$    #
##*$#$###
##+   ###
#########
