#############
#    ########
#  #.#####  #
#   .*.* $  #
#  #.  $@#  #
#  #.### #$##
# $    $ #  #
## ######## #
##          #
#############
