###############
##   ###    ###
#      # ##   #
#  $ #   #  # #
#  #$##### ## #
# *......*.#  #
# $ $####$$$ ##
##   #### @####
###############
