###########
##      ###
# .#$*# $ #
# * $.  $@#
##* #. ####
##. $.   ##
##       ##
###########
