########
##     #
##$..* #
# $.*. #
# $*** #
#@$    #
#####  #
########
