###########
#     #####
# ###$#####
# # ..*@$ #
# # . #$$ #
# #$.   # #
#   . #   #
###########
