############
##   #######
##$#     ###
## #####  ##
## #   #.$##
# $ .#$#   #
# # @$     #
# ...#######
############
