########
## . ###
## .@$ #
# $*$  #
#  . ###
# $* ###
## . ###
########
