##########
##   ##  #
##    $  #
### ###  #
### # .. #
### $  #.#
# $$# ##.#
#  @     #
##########
