########
###@ ###
###$ ###
#   $###
#   .$ #
###. . #
########
