###############
####    #######
####$##  ######
###  .#  #  ###
###   #  $ $  #
##### ## #. # #
####. .*.## # #
#    #*#*#  # #
# #$##.*.     #
# #  #.##$#####
# $  $      ###
###  #$ #@  ###
######  ## ####
#######    ####
###############
