##############
#########  ###
####@ $     ##
#### $### # ##
#   $ ## .#  #
#  #    ** # #
## ####... # #
##. ### # #  #
##$  $  $   ##
##. ####   ###
##############
