#############
####    #####
##     *#  ##
##$$ $ $ $ ##
## #*#*# # ##
# @*.. ...  #
#   #####   #
#############
