#########
###   ###
# $ #$  #
# ....* #
#  *. $ #
## # # ##
## $$* ##
### @ ###
#########
