##########
####   ###
## $ # * #
## $*.*  #
#  *   . #
#@  ###  #
##########
