#########
####   ##
## .$.$##
#  .** ##
# * . * #
##   $$ #
##  ## @#
#########
