#########
#####   #
###..$. #
# $ $.$##
# #$. * #
#  . *$ #
##   # @#
#########
