############
##   #######
##     $@###
### ##.#*###
### # $  $ #
# $ .$. .# #
#   $ ##$# #
###.#.  .  #
###   ######
############
