#########
##  #  ##
#     $ #
# ** **@#
# * # * #
##  .  ##
##  .$###
###   ###
#########
