###########
####   ####
###  #$$  #
##  #   *@#
## ##.#$###
##  ... ###
#  .#*#   #
#   $ $ # #
#### .  $ #
######  ###
###########
