###########
#   #######
#    $ ####
##  $# ####
## #..* ###
##.*. # @##
###$# *$###
###   $. ##
####   $. #
#######   #
###########
