###########
#   ##   ##
#    $    #
##$## ... #
#  $ #*#.##
#    *+#.##
#  $$##  ##
#  #  #$ ##
####   $ ##
#### .#####
###########
