###########
#######   #
#  #@$    #
# . *$#$$ #
# *.  #  ##
##  # $ ###
###.**# .##
###.     ##
####  #  ##
###########
