###########
#    .  $@#
#  *# #*  #
##  *.. ###
##$ #.#$ ##
##  $.$  ##
##  ###  ##
###########
