############
#   #@   ###
#   ***# ###
## #.*.#$  #
## # *.    #
##  #.### ##
##  #     ##
##  $ $#  ##
##### $ ####
#####   ####
############
