##########
###@ #####
###$$*   #
# * $ *# #
# #. $ . #
#   .. ###
#####  ###
##########
