###########
#####  ####
##  #  ####
##  *.  ###
## .*.#   #
###$.$$ # #
#@$...##  #
# #$# $  ##
#   #  ####
#### $ ####
####   ####
###########
