###############
#########  ####
###       $####
### *####. ####
### .   #.$####
####$#$.#. ####
#  $ #  $     #
# ##.#  ####* #
# # .#### @   #
# #  $     #  #
#    ##    ####
###############
