#########
#      ##
#  # ** #
#   $ . #
##$#$#.##
#  *@$. #
# . #.$ #
##     ##
#########
