############
####     ###
##   ###  ##
##      # ##
###$#@  # ##
#   ##### ##
#   #  *. ##
##$$#  *.###
##     *..##
##### #...##
##### #$$$ #
#####   $  #
#########  #
############
