##################
#######    #######
####### @  #######
#######      #####
#  ####..#.#$#####
# $ $ ##...      #
#     .....#$$   #
###### ##$## #####
######  $    #####
######### ########
########  ########
########  ########
######## $    ####
######  $ $   ####
###### #$# #######
######     #######
##################
