##################
############  ####
##  $ $ $ $   ####
##  # # # # #$####
###. . . . . .####
###$# # # # #$####
###. . . . . .   #
###$# # # # # @  #
###   $ $ $ $  ###
###  #############
##################
