#################
######     ######
#  . ..$#$.. .  #
#  $ $  .  $ $  #
###$####@####$###
#  $ $  .  $ $  #
#  . ..$#$.. .  #
######     ######
#################
