##############
#########   ##
######### $  #
### $ $ $ #$ #
###   #. $   #
#####.#.# $###
##   ..... ###
##  $ ..##$###
### ## ..  ###
#  $.#$ # $###
#   $   #  ###
##@  #  ######
###  #########
##############
