###############
####@ .###  ###
####  $$ $    #
#   # . . ##  #
#  $ # . . ## #
## .  $ $$  # #
## #  ###.  # #
## #### ##### #
##       #    #
######## # ####
######## .$ ###
#########   ###
####### #######
###############
