##########################
######   #################
######   #################
######  ###########    ###
####    ########### #$$  #
####$   ########## $  $  #
###  ## ..........$  #$$@#
#    # $$# ####### $     #
#   $  #...#########  ####
#   #   $ ################
########    ##############
########    ##############
########    ##############
##########################
