###########################
################   ########
####  ########## $    $ ###
####  ##########  $##$  ###
####     #########  # $ $ #
####      ..........#   $ #
####### ##....@###  # $$  #
##    # #####.#### ##   $ #
##            ####$  $$ $ #
#### #  ##### ####  $  #  #
#    # #      ######   ####
#      #  #   #############
#   #     #################
#####     #################
###########################
