########################
####   #################
####   #################
##  ***    # # #########
##  * *    ## # ########
##  ***   ## # ##   ####
####   #### # # #   ####
####   # # # ####$ $####
####   ## # ##  $...$ ##
######## # ##    .@.  ##
######### # #   $...$ ##
#################$ $####
#################   ####
########################
