###################
############    ###
#####  ####  ## ###
###    #### #   $ #
#  $ @ ...*..  $  #
# $ $  ## ###   ###
### ###   #########
##      ###########
##   ##############
###################
