#############
#####     ###
##### ###  ##
#       #  ##
#@$***. ##$ #
#  #    ## .#
##  ##  # $ #
###  ####.$.#
####        #
#########  ##
#############
