#########
#. .    #
#.$. .  #
## ###@ #
##  $  ##
## $$ ###
##  $ ###
##  #####
#########
