##########
#   ######
# $ $ $ ##
### # # ##
### #   ##
### ### ##
## .....@#
## $ $   #
## ### ###
##     ###
##########
