#################
#####   #########
##### # #   #####
#####     # #####
######.# ...#####
##  .$$ ###$#   #
## #.#     $. # #
##  .# $$$  #   #
###  # $@$ #  ###
#   #  $$$ #.  ##
# # .$     #.# ##
#   #$### $$.  ##
#####... #.######
##### #     #####
#####   # # #####
#########   #####
#################
