##############
#####     ####
##### ###$  ##
#####....$   #
##### ## #   #
###@.$  # # ##
# .*.$   ## ##
#  $.$  #.$$##
#  ## ##    ##
#####   # ####
#######  $ ###
########   ###
##############
