########################
#   ####################
#  $ ###################
##  $ #  ###############
### $ # $###############
####      $ $ $ $  #####
########$ # # #  # #####
########      #    #####
######## #######$#######
########         #@#   #
#######  # # ##  #     #
#######..*.*.*......   #
################    # ##
###################   ##
########################
