##################
##   #############
#    ###  ########
#  # @#   ########
##$####   ########
# ...    ##    ###
# ...  #    ##  ##
#### # #####  # ##
#### #       $#  #
#### # $ $ $$  # #
####  #####    # #
#####      #   # #
##########  ###  #
###########     ##
##################
