#################
###########   ###
##########     ##
##########    @ #
############ #. #
#            #.##
# ############.##
#             .##
##$#$#$#$#$#$#.##
##            .##
#################
