################
########   #####
######  $$ #####
#  ###  $  #  ##
#    ###$$  $ ##
# *#  @  ## # ##
## ##### #..# ##
##    ## #..#  #
###  $ # #..   #
# ## $ #  ..####
## ##    #  ####
### ####   #####
################
