#######################
#         #############
# $## ### #############
#  # $ $ $ #####   ####
# $    #     # $. .  ##
#  ##$###$## # #...# ##
# $    #     # #. .# ##
## # $ $ $## # #...#  #
#  ## ### #. # #. . # #
# $       #    #    # #
# @######## ###     # #
##########       ###  #
########## ####  #   ##
##########     ##  ####
##############    #####
#######################
