############
######   ###
###  . # ###
### $. $ $ #
### #.## $ #
###@#..#$  #
#   ##.#  ##
# $ $ .# $##
## ###.## ##
##        ##
######  ####
############
