#######################
############   ########
#     # # ## # # #   ##
# # #$  $  # .$  $ # ##
#  ..*.** *@* **.*..  #
## # $  $. #  $  $# # #
##   # # # ## # #     #
########   ############
#######################
