##########
#  . . ###
# $.$. ###
##$#$# ###
## . .  ##
##$#$# @##
## . .  ##
##$#$# ###
#  . . ###
# $#$# ###
##   . . #
####$#$# #
#### .   #
####$# ###
####   ###
##########
