#############
#########  ##
#          ##
# #*### #  ##
#  $   # # ##
#*#*##  #  ##
#  $  #  # ##
#  *#  # # ##
#  $ # # # ##
###$. . . . #
###@####### #
###         #
#############
