###############
##         ####
#  #######$####
# #       $ ###
# #...***.*.@ #
# #       $ # #
#  #######$#  #
##        $  ##
#########   ###
###############
