###########
########@ #
#   ...#$ #
# $ $ $ * #
#####   . #
#####$#$. #
####. # .##
##  .$#$ ##
##  .$   ##
####.$#  ##
####  #####
###########
