########
#    ###
# .$ ###
# ** ###
##$. ###
##  ####
## ##  #
##  #  #
##     #
##.**$@#
##  #  #
########
