##########
######   #
#  $     #
#  $### ##
##.$. . .#
## $#    #
## @######
##  ######
##########
