##############
#### @ ###   #
#### # $     #
#### #$ $ ####
#    # $ $####
# ### $ $ ####
#.......# ####
#### ## #  ###
####    #  ###
#########  ###
##############
