#############
###   #   ###
## $# # #$###
#   #. .#   #
# $ *.@.* $ #
#   #. .#   #
###$# # #$ ##
###   #   ###
#############
