################
###########  ###
###########    #
###########$$  #
####       $  ##
#### #### $$ ###
####....# $  ###
#   ...# $$  ###
#  #...# $ #####
# @## ## $ #####
#         ######
#  #  ##########
################
