########
##  ####
## .####
#  .$ ##
#* *  ##
# $.$$ #
#  .   #
###*####
###@####
########
