#################
## $.       .$ ##
#  # ####### #  #
# #           # #
#  .***$#$***.  #
###     #     ###
### ####@#### ###
###           ###
#################
