#######################
#################     #
########    ###  $$##.#
######  $ $ ### #$ ##.#
## $ $   #      #    .#
## # # $ #  ### #  ## #
# $  $   ######  ##   #
# $#.*##$ ######    ###
#.*..... .#############
#  .###################
## @###################
##  ###################
#######################
