###########
##       ##
# .#####  #
# .     # #
# * $$  # #
# *## ##  #
# *   #  ##
# *## # ###
# +   # ###
# $###  ###
##     ####
###########
