#########
####  ###
### .$###
# $$.$ ##
# . .  ##
## $.$###
###$.$  #
### . . #
### .$$ #
####. ###
####@ ###
#########
