############
###      ###
###*####.###
#    $ $ ###
# #......###
# #$ #     #
# #. #@# # #
# $$## #$# #
#  $   $   #
#  #########
############
