#######################
#########   ###########
########  $ ###   #####
#    ### #$#### #    ##
#   ##   #  # $$ ###  #
#  ###  ##$ @ $     # #
#  #  . # $$ # $ $$ # #
#..#  .##   $#     ## #
#     . ##$  ####     #
#..##.#      ##########
#     . #   ###########
#..#  .  ##############
#  ###.# ##############
######   ##############
#######################
