################
#########  #####
#########  #####
#########  #####
########## #####
#    $ $ $$#####
# @  $..*. #####
#   # *...$#####
#####$...* #####
##### .*..$#   #
#####$$ $ $    #
##### ##########
#####  #########
#####  #########
#####  #########
################
