###########
##   #   ##
## # # # ##
# *.*$*.* #
#    #    #
### $@$ ###
#    #    #
# *.*$*.* #
## # # # ##
##   #   ##
###########
