#########
####   ##
#### # ##
# . .# ##
#  .   ##
# .## $##
##  #$$ #
###   $@#
####  ###
#########
