##########
#  ###  ##
#  # $$ ##
# $$ #  ##
#    #  ##
### $.#  #
###..*.@.#
####   ###
##########
