#############
###  ########
###$ ########
###  ########
### ####  ###
#  .. ..  ###
# $*. *.$@  #
## #$ $#$ # #
## #   #  # #
##  ######  #
###        ##
#############
