###########
##  ..... #
#  #..... #
# $ #### ##
# $  @   ##
## $ $ $ ##
## $$$$$ ##
##   #   ##
###########
