########
####  ##
# $...##
#@ $.. #
###$$$ #
###    #
########
