############
##    # @ ##
#  $.... $ #
# $ ####$  #
##  ####   #
############
