####################
#####      #########
##### #### #@##  ..#
# $  $           ..#
#   # ### #####  ..#
### # ### ##########
###  $  $ ##########
#####  $############
#####$  ############
#####   ############
####################
