##########
#######@ #
#   #    #
#   $  $ #
## ##$# ##
##  $ #*.#
###  $...#
###   #. #
##########
