#########
## @    #
##  ..$ #
#  #..###
# $$$####
#    ####
#########
