################
#  ##  #########
#  ##$ #########
#  $   #########
## #    ########
## ## #  #######
## $ $## #######
## ##    ####..#
# $ #$ #$##  ..#
#      $     ..#
########@##  ..#
################
