#########
##  #  @#
##$  $  #
## ## $ #
##...$ ##
# ...# ##
# #$$  ##
#      ##
#########
