##########
##     ###
## $  $ ##
### # #@##
###.# $ ##
###..$ ###
#  ..# ###
# #.*# ###
#  #.$$$ #
##   # # #
####     #
##########
