##############
#######@#   ##
######  # $ ##
#####  # $  ##
##    # $ # ##
##   # $  #  #
##  # $  #   #
## # $  #    #
##  $  ### # #
#  $  ##...# #
#   ##.....  #
########  ####
##############
