###############
#####....######
#####....#  ###
#####...  $ ###
#####   #   ###
#   #####$#####
#   #      # ##
## $  $#     ##
##$ ## # $ $ ##
##  $   ####$##
## # #  ####  #
## $       $  #
#@  ########  #
###############
