#################
#....############
#....############
##   ############
##   #  #   #   #
### ## $ $ $$   #
###    @# # #####
###  ##$# $  ####
######   $   ####
###  $   ########
###      ########
#################
