#########
####   ##
#### #  #
#### $  #
##   # ##
# .#.#  #
# ..*$$ #
# *#.#  #
##  ##$##
##$ @  ##
##  #####
#########
