########
#.   $ #
#.$  # #
#.# #  #
### # ##
## $  ##
##@ ####
########
