###########
#@  #######
# #$#  #  #
# $    $$ #
### ##$#  #
##  # .# ##
##  $..   #
##  #..## #
######.   #
###########
