##################
# @###############
# $###############
#  $   ###########
#   $#  ######   #
##   $  ###### $ #
###$# $ #######  #
###   #$    #  ..#
### # # $## # #..#
###      $     ..#
#############  ..#
#######     #$#..#
####### $      ..#
#######     #   ##
##################
