################
#     ##########
# ### ##########
# #  $  ########
# # $ $ ########
# #@ #$  #######
# # $# $$#  ...#
# #$ #   #  ...#
# #  #$     ...#
# #$ #  $#  ...#
#   $ $  #  ...#
###  $  $#######
##### ## #######
#####    #######
################
