################
##@#############
# $#   ##  #####
#      $   #####
# $##$###  #####
#  ## ### ######
#####.###   ####
#####....#  ####
#####....#  ####
#####....## ####
###### ####  ###
####         ###
####   #### ####
########  $ $  #
######## $ $   #
######## $$$$$ #
########       #
################
