#################
##     ##########
## $ $ ##########
## $ ############
## $##  #########
#   #  $  ......#
# *##  #$ #  $  #
#.....*.  ## $  #
#.###   ##  ##$ #
##########      #
#######@$  $ $$ #
#########   #   #
#################
