###########
##     ####
## ###.   #
##    # # #
# .#$ $ # #
# #  *  # #
# # $ $#. #
# # #    ##
#   .### ##
####      #
########  #
########@ #
###########
