##############
#######     ##
###   # ##$ ##
# $   #      #
# $# ##$# #$ #
#@ # # $  #  #
# $# # $###$ #
# $  $    # ##
## # $# #    #
# $#  ..##. .#
#  ### ..#.# #
#   ## ......#
##############
