#################
#########     ###
#########     ###
#####   ## ##...#
#     # ## ##...#
# ###$$$ $ ##...#
# #   $ $  ##...#
# # #$ $ $###...#
# #   $@$   ## ##
# #  $ $ $ $#  ##
# # ######     ##
#              ##
#################
