##############
###  #########
###  #########
### $$ #.....#
###    #.*...#
####   $..##.#
##  #$##$  #.#
## $  ## ## .#
##  ##  $ $ ##
###@ #$    ###
#  $$ $   $###
# $  ####  ###
#    #########
#   ##########
##############
