############
####  ######
####$     ##
##     .# ##
## ## #.  ##
## $  #*####
## ####.   #
#  #  @.#  #
# $  #$.#$##
###    . $ #
########   #
############
