#############
# @##########
#  #####..###
#  # $  $...#
##   #  ... #
##$$  ###$# #
##  # ### $ #
# $   $   # #
#    ####   #
#############
