############
######   ###
###    #@###
### ###  ###
### #  $ ###
### # # $$ #
### # $$   #
### #   #$ #
#   # $$ $ #
# $ $      #
##$#########
# ....######
# ....######
# ....######
############
