####################
#       #######   ##
# # # # #         ##
#   $ $ # ###### ###
#####$#$# #  ..  ###
###  @$  $   ..# $ #
### #$#$# ###... $ #
###       ##...#   #
####################
