##############
###.......####
###.......####
###         ##
####  ##### ##
#### ##   # ##
#### #   $  ##
####  $ $ ####
####$#   $ @##
###  ## # $###
###$  $$#  ###
#       #$   #
# # $ $ $  $ #
# ###### #  ##
#        #####
##############
