#################
#....   #########
#....   #########
#.#... ##########
#....#  #########
######$$   #   ##
####    ## $$# ##
####  #  ##  $ ##
##### $ $   ## ##
####   # $   # ##
####   $ #$  # ##
##### ## # $ # ##
#####$ #$#  ## @#
#####  # #$$ $  #
#####          ##
#################
