############
###  #######
###  #######
###   ######
#   # ######
# . @ #  ###
##.# #     #
##.# #$$$$ #
##.**$     #
####. ##   #
####  ##  ##
############
