############
#########  #
######     #
###### **  #
###  #  #  #
##  *** ####
##$ ..... ##
# $ # $ $ ##
#   ####$ ##
####### @  #
#######    #
############
