###############
##  ###########
##. #  ########
#  *$$ ########
#  $.      ####
#####*###. ####
###   * *   ###
### #.$@$.# ###
###   * *   ###
#### .###*#####
####      .$  #
######## $$*  #
########  # .##
###########  ##
###############
