###########
########  #
###    #$.#
### ## #  #
## $ $$$$ #
##.*.*.*..#
#     @   #
#   #######
###########
