##########
#   ##   #
# $.  .$ #
# .**$*. #
## $ @* ##
## *  $ ##
# .*$**. #
# $.  .$ #
#   ##   #
##########
