##########
##    ####
##.$.$.$ #
##$.$.$. #
# .$ @.$ #
# $.  $. #
# .$.$.$##
# $.$.$.##
####    ##
##########
