##########
###     ##
# $.*.*$##
# *#$ #. #
# .  @$* #
# *$   . #
# .# $#* #
##$*.*.$ #
##     ###
##########
