##########
#       ##
# $.$.$. #
# .$.$.$ #
# $.##$. #
# .$##.$ #
# $.$.$. #
# .$.$.$ #
##      @#
##########
