##########
##      ##
#  *..*  #
# #$  $#@#
#  ****  #
##     ###
####  ####
##########
