############
####  #   ##
###   # # ##
###       ##
###   ## ###
####    .###
########.###
#####  #.###
#####  # ###
##         #
#  ##$##.  #
#  $ $ #####
#  $ @ #####
##  ########
############
