###########
##     ####
## $ $ ####
### ## .  #
#   #. $  #
# @  .#*###
### #.. ###
## $ #  ###
#   $ $ ###
#   ##. ###
###########
