##########
####  ####
## $$. ###
## .$.$$ #
###  . . #
### @# ###
# . .  ###
# $$.$. ##
### .$$ ##
####  ####
##########
