#########
##### @ #
#  $  $ #
#  ****.#
#  . #  #
#  ### ##
##     ##
#########
