###############
###  ##########
###$.##########
###  ##########
#           ###
# #.***..*#.###
# $$$  @  $$$ #
###.##### #.# #
###           #
##########  ###
###############
