#######
# * .##
#.  $##
#.#$.##
#   $##
##@ $ #
##    #
#######
