###########
#######  ##
#    *   ##
#  .$.$. ##
## $###$ ##
##*.# #.*##
## $###$ ##
## .$.$.  #
##   *    #
##@  ######
###########
