############
#    #######
# ## $ $ $ #
#  . # # # #
###..$  @  #
###..# #####
#### #$#####
####   #####
############
