#########
#####   #
#####$  #
#### *. #
### .$ ##
### .* ##
## $@$ ##
## *. ###
## $. ###
# .* ####
#  $#####
#   #####
#########
