#########
######  #
##      #
## ###  #
##$* # ##
# *..#  #
#   $$$ #
##*. $ ##
# $*.  ##
#  . ####
## . ####
## @#####
#########
