#############
#####  ######
##  # *######
##.$#  * ####
#   @ * * ###
#   #  * * ##
##### * * * #
###### * *  #
######  * * #
#######  * ##
########   ##
#########  ##
#############
