##########
######   #
###   $  #
###  #$###
#  * .  ##
# * * #@##
#  * *  ##
### * .###
####   ###
##########
