#########
#   #   #
# # #   #
# .$..$##
#  $..$ #
###$#@# #
## $.   #
##   ####
#########
