############
###@  #  ###
### $  $   #
####$##$## #
# .* .* .*.#
#          #
##  #  #  ##
############
