#########
# $ .   #
#   #   #
#*** ***#
#   # @ #
#  .$.$ #
#########
