############
########  ##
#######   ##
######  $ ##
###  # .$###
### *$* * ##
## + . .  ##
#   . *$* ##
# $*$. #  ##
#  #  ######
############
############
