#############
###### ######
#####   #####
#### $.$ ####
###  .$.  ###
## $.$.$.$ ##
#  .$.@.$.  #
## $.$.$.$ ##
###  .$.  ###
#### $.$ ####
#####   #####
###### ######
#############
