#############
###### ######
##### @ #####
####  .  ####
### $*$*$ ###
##  * . *  ##
#  .$.#.$.  #
##  * . *  ##
### $*$*$ ###
####  .  ####
#####   #####
###### ######
#############
