##############
#######     ##
####    ###  #
#### ###   # #
### $.$.$  # #
### * + * #  #
###.$.$ $.#  #
#   * * *  # #
# ######   # #
#       ###  #
#######     ##
##############
