###########
# ###  ####
###  *   ##
##  *$$.  #
## * ..$  #
# *$.@.$* #
#  $.. * ##
#  .$$*  ##
##   *  ###
####  ### #
###########
