###########
#####  ####
###  *.  ##
##  *$$.  #
## *  .$. #
# *$ @ $* #
# .$.  * ##
#  .$$*  ##
##  .*  ###
####  #####
###########
