###########
#######  ##
### $ $$ ##
###   #  ##
### ### ###
#   #     #
#...*.....#
## #$## ###
## #  # ###
##$#@ #$###
# $    $ ##
#   ##   ##
###########
###########
