##############
##         ###
##.#.$.#.#$###
# $.$#$. .   #
# .$. . .#$#@#
# $.#*#.#  $ #
#  #  $ $   ##
# $$   #######
#  ###########
##############
