###########
####  #####
##  $.$  ##
## #.. # ##
##$ $ $.$ #
# .. # .. #
# $.$ $ $##
## # ..# ##
##  $.$  ##
#####@ ####
###########
