#########
#  ######
#  #  ###
#.$*$. ##
#      ##
# .$*$.@#
##  #   #
#########
