############
#########  #
#######    #
#   $      #
#   $### ###
###.$... .##
### $#    ##
### $ ######
### @ ######
############
