#################
#  ##############
#      ####   ###
#  ###  ### # ###
#  #  #  ##  $  #
#      #  #  $  #
#  #    # $$ #  #
#####   ### $####
####  ###@##  ###
####    .... .###
#####  ##########
#################
