################
###    #####   #
#   ##  ### $  #
# @   # ## $  ##
## ## ....*  ###
# $   $###  ####
#   #  #########
################
