'S15#v2'###
###########
####@ #####
####  #####
### .$#####
###$. #####
### .$#  ##
#  ..*.$ ##
# $ $ #  ##
##### # ###
##### #  ##
#####    ##
#######  ##
###########
