###########
####  #####
#  $ @ ####
#  ## $  ##
##.## .#  #
## #. $ $ #
##.# $.#  #
##    #####
##  #######
###########
