###########
## #  #####
#  $    ###
##. * #  ##
#  * * # ##
#   *@*   #
## # * *  #
##  # * .##
###    $  #
#####  # ##
###########
