#########
##    ###
## * *  #
# *.$.* #
#  $@$  #
# *.$.* #
#  * * ##
###    ##
#########
