###########
####    ###
#### #  ###
#  .$.$.###
#  $.$.$  #
# #.$@$.# #
#  $.$.$  #
###.$.$.  #
###  # ####
###    ####
###########
