###########
####  #####
##   *  ###
##  $.$   #
# *.*@*.* #
#   $.$  ##
###  *   ##
#####  ####
###########
