#############
#####   #####
###   #   ###
## # ..* # ##
##   $*$   ##
#  *$# #$.  #
# #.* @ *.# #
#  .$# #$*  #
##   $*$   ##
## # *.. # ##
###   #   ###
#####   #####
#############
