##########
##   #####
## #$$ $ #
## .@.   #
# *.#..###
#   $$  ##
#####   ##
##########
