########
#   ####
# #  ###
# #$.###
# #.$  #
#  $.# #
# #.$  #
#  $.#@#
###.$# #
###  # #
####   #
########
