##############
#####   ######
###. @# ######
###*#$  #   ##
###. $ #    ##
### ###  * * #
###   * * *  #
###  * * *  ##
### * . *   ##
###* # #######
# $ *  #######
#     ########
###  #########
##############
