##########
##  ######
## $######
#  @ #  ##
# . *#$.##
### * $. #
###      #
##########
