#############
#####  ######
##  #  $ $ ##
##$.#$ . . ##
##  # .######
##$.#* * $  #
#   . @ .   #
#  $ * *#.$##
######. #  ##
## . . $#.$##
## $ $  #  ##
######  #####
#############
