#############
#####  ######
#####  ######
#####$ ######
##### .######
#####* * $  #
#   . @ .   #
#  $ * *#####
######. #####
###### $#####
######  #####
######  #####
#############
