#############
#####  ######
##### $######
#####  ######
##### *######
#####. .    #
# $ * @ * $ #
#    . .#####
######* #####
######  #####
######$ #####
######  #####
#############
