################
#####  #########
####   ####  ###
##  .*$ ##   ###
##  *.$ #  *. ##
###   # #  .*  #
####  # ###$$  #
#######@     ###
###      #######
#  $$### #  ####
#  *.  # #   ###
## .*  # $.*  ##
###   ## $*.  ##
###  ####   ####
#########  #####
################
