################
#####  #########
####   ####  ###
##  .*$ #    ###
##  *.$ #  *. ##
###   # ## .*  #
###  ## ###$$  #
#######@     ###
###      #######
#  $$### ##  ###
#  *. ## #   ###
## .*  # $.*  ##
###    # $*.  ##
###  ####   ####
#########  #####
################
