########
#  #####
# @#####
#   $  #
# * .  #
### ####
###   ##
###$#. #
### #$ #
# . #. #
#    $ #
#  ##  #
#  #####
########
