###########
###   #   #
# * $ . . #
#   $ ## ##
####*#   ##
##  @  ####
##   ######
###########
