############
##.......  #
# $$$$$$$@ #
#   # # # ##
# # #     ##
#   ########
############
