###############
#  #######   ##
#    #####$ $ #
#..# ##### #  #
#  @    # $ $ #
#..#         ##
##   ##########
###############
