#########
###  ####
### $####
###. .  #
# $ # $ #
#  . .###
####$ ###
#### @###
#########
