############
###  #######
#    #######
# # . .#####
# @ ...#####
# # # #   ##
#   # $$   #
#####  $ $ #
######$ # ##
######    ##
############
