######
# @ ##
#...##
#$$$##
#    #
#    #
######
