#########
###    ##
### ##@##
### # $ #
# ..# $ #
#       #
#  ######
#########
