##########
######   #
####.....#
# @$$$$$ #
#     # ##
#####   ##
##########
