########
### . ##
### $  #
# . $#@#
# #$ . #
#  $ ###
## . ###
########
