##########
##   #####
#  $  ####
# $ $  ###
###$# . ##
### # .  #
### ##.  #
## @  . ##
##   #  ##
##########
