#########
###  ####
###  ####
###$.$  #
#  .@.  #
#  $.$###
####  ###
####  ###
#########
