########
# @#  ##
#.$   ##
#. # $##
#.$#   #
#. # $ #
#  #   #
########
