###########
#   #######
# #$  #####
# $   #####
# $ $ #####
# $#  #####
#  @#######
## ########
#      ...#
#         #
########..#
###########
