#########
#   #####
# $  ####
## $ ####
####@.  #
###  .# #
###     #
#########
