#########
#  ######
# $   ###
# .#  ###
# $# ####
# .  ####
#### ####
#### ####
#### ####
##  $  ##
## #$# ##
# $ @ $ #
# ..#.. #
###   ###
#########
