##########
# @#######
#.*  #####
#..#$$ $ #
##       #
## # ##  #
##   #####
##########
