##########
##      ##
##@   $ ##
## ###$ ##
# .....###
# $ $ $  #
###### # #
######   #
##########
