#########
##     ##
## ###$##
#.$   @ #
# .. #$ #
#.##  $ #
#    ####
#########
