############
####  ######
## $$ #   ##
## $ . .$$##
## .. #. $ #
### #** .  #
#  . **# ###
# $ .# .. ##
##$$.@. $ ##
##   # $$ ##
######  ####
############
