##########
##  ######
##     ###
## ##   ##
#. .# @$##
#   # $$ #
#  .#    #
##########
