##########
##   #####
#  $$$  ##
# #   $ ##
#   $## ##
###  #.  #
###  #   #
###### ###
##   # ###
## @....##
##      ##
##   #  ##
##########
