########
#   .. #
#  @$$ #
##### ##
####  ##
####  ##
####  ##
########
