#########
######@##
#    .* #
#   #   #
#####$# #
#####   #
#########
