#######
###   #
###$$@#
#   ###
#     #
# . . #
#######
