#######
#   .##
# ## ##
#  $$@#
# #   #
#.  ###
#######
