###########
######   ##
######    #
#######   #
##     #. #
# $ $ @  ##
# ######.##
#        ##
###########
