######
## @ #
##   #
###$ #
# ...#
# $$ #
###  #
######
