##########
#   ######
# # # .###
#    $ ###
### #$.  #
#   #@   #
# # ######
#   ######
##########
