#######
##   ##
##   ##
# $$$ #
# .+. #
#######
