#######
##    #
#  ## #
# # $ #
#  * .#
## #@##
##   ##
#######
