########
#     ##
#@$$$ ##
#  #...#
##    ##
########
