########
##     #
## .$. #
## $@$ #
#  .$. #
#      #
########
