##########
# @ #  ###
#      ###
#####$ ###
#####  ###
#####$ ..#
#####  ###
##########
