#######
#   ###
#  $  #
##* . #
##   @#
#######
