########
###  ###
###@ ###
###  ###
### ####
#    * #
#  $   #
#####. #
########
