##########
###  #####
#  $  @..#
# $    # #
### #### #
###      #
##########
