#########
#      ##
# #### ##
# #...@##
# ###$###
# #     #
#  $$ $ #
####   ##
####.####
#########
