#######
#   ###
# #  ##
#@$*.##
##  . #
## $# #
###   #
#######
