#########
####@####
####$####
##  .  ##
#  # #  #
# #   # #
# #   # #
# #   # #
#  # #  #
## $ $ ##
###. .###
###   ###
###   ###
#########
