#############
####    ##  #
#  $$$....$@#
#      ###  #
#   #########
#############
