##########
##       #
##@##### #
#  #   # #
#  #   $.#
#  ##$##.#
##$##  #.#
#   $  #.#
#   #  ###
##########
