############
#    ###   #
# $$     #@#
# $ #...   #
#   ########
############
