#########
###    ##
###  $ ##
#####$ ##
## $ $ ##
#....# ##
#     @ #
##  #   #
#########
