###################
#   ##### .########
#       $  ########
###  #### .$    @ #
###  ####  ####   #
###################
