###########
##  #######
##$ @#   .#
## #$$   .#
#  $  ##..#
#   # #####
###   #####
###########
