##########
##    #  #
## $#$#  #
#  .$.@  #
#  .#    #
##########
