##########
##   #####
#    #####
#  #.#   #
#@ #.# $ #
#  #.#  ##
#    #  ##
##  ##$$##
###     ##
###  #####
##########
