###########
######  ###
####    ###
####  # ###
####$ #.###
####  # ###
####$ #.###
####  # ###
####$ #.###
# @     ###
#   #  ####
###########
