#########
#####  ##
### $   #
## $  # #
# @#$$  #
# ..  ###
# ..#####
#########
