#########
######  #
#       #
#  ... .#
##$######
# $  ####
#   $####
##  $  ##
### @  ##
#########
