############
#  ... #####
#  ### #####
#  # $  ####
## #@$  ####
## # $  ####
## ### #####
##         #
##   ###   #
############
