##########
##  @   ##
## $  $ ##
### ## ###
#  $..$  #
#   ..   #
##########
