######
#.  ##
#@$$ #
##   #
###  #
####.#
######
