#######
###  ##
#  . ##
# #*  #
# $.#@#
##$.# #
#  $  #
#   ###
#  ####
#######
