##########
## . #####
##$ $$ $ #
## .. . .#
##$   .$ #
# $.   $##
#. . .. ##
#@$ $$ $##
##### . ##
##########
