########
####  ##
##     #
##*  # #
# *$*. #
#  @  ##
########
