############
####  ######
###   ######
###       ##
###   #   ##
####    .###
########.###
########.###
###     .  #
###  #$#.  #
#  $$ $ ####
#   $ @ ####
###  #######
############
