###########
####  #####
#### $#####
###  .  ###
### .$.   #
# $.$@$.$ #
#   .$. ###
###  .  ###
#####$ ####
#####  ####
###########
