######
#  ###
#  ###
#  ###
#.$$@#
#  . #
#  ###
######
