#######
#   ###
#   ###
#$$$@ #
#...  #
#######
