################
#  #   #########
#      #########
#  ## ##########
## ##  #       #
## ##  #       #
## ##  $ $ $ $ #
## ### #######@#
#    . . . .   #
#   ############
################
