###########
########  #
##   ##   #
#    #  $ #
# # ##$  ##
# #   $ ###
#@# .#$ ###
#  ..  ####
###. ######
###  ######
###########
