############
###  #######
###  #######
#  $ .######
#  $#.###  #
#  $ .#    #
#####.# $  #
#####.#$#@ #
###  .  $  #
###   ###  #
####  ######
############
