##########
####    ##
#    ## ##
# ##     #
# #  #   #
#  $$#$$ #
###$ $ $##
###     ##
#####@####
##  . .. #
## .. .  #
## .##   #
######   #
##########
