#########
###  ####
##  $$  #
## #  # #
## $ $# #
## #  # #
##@#  # #
## #$#  #
# .....##
#   #####
#########
