##################################
#####     #                  #####
####  #  #  ################  ####
###  #  #  #                #  ###
##  #  #  #  ##############  #  ##
#  #  #  #  #              #  #  #
# #  #  #  #  ############  #  # #
# # #  #  #  #            #  #   #
# # # #  #  #  ##########  #  #  #
# # # # #  #  #          #  #  # #
# # # # # #  #  ########  #  #  ##
# # # # # # #  #        #  #  #  #
# # # # # # # #  ######  #  #  # #
# # # # # # # # #      #  #  # # #
# # # # # # # # # ####  #  # # # #
# # # # # # # #       #  # # # # #
# # # # # # #   ## ##  # # # # # #
# # # # # #  ## ##   # # # # # # #
# # # # #  #    @.$# # # # # # # #
# # # #  #  #### # # # # # # # # #
# # #  #  #      # # # # # # # # #
# #  #  #  ######  # # # # # # # #
#  #  #  #        #  # # # # # # #
##  #  #  ########  #  # # # # # #
# #  #  #          #  #  # # # # #
#  #  #  ##########  #  #  # # # #
#   #  #            #  #  #  # # #
# #  #  ############  #  #  #  # #
#  #  #              #  #  #  #  #
##  #  ##############  #  #  #  ##
###  #                #  #  #  ###
####  ################  #  #  ####
#####                  #     #####
##################################
