###############################################
###########  ##################################
###########  ############  ####################
#######   #  ############  ###########  #######
#######     #########   #  ###########  #######
##########     ######     ########   #  #######
########## #   #########     #####     ########
########## #########   # #   ########     #####
########## ##  #####     ########   # #   #####
######   # ##  #  #####     #####     #########
######     ##  #  #  ## #   #  #####     ######
#########     ##  #  ## #####  #  ## #   #  ###
########  ##     ##  ## #####  #  ## #####  ###
########  #  ##     ###       ##  ## #####  ###
########  #  #  ##       ###     ###       ####
###########  #  #  ##### ##  ##       ###     #
##############  #  ##### ##  #  ##### ##  #   #
##########  #####  #   # ##  #  ##### ##  #####
##########  #  #####     #####  #   # ##  #####
######   #  #  #  #####     #####     #########
######     #####  #   # #   #  #####     ######
#########     #####     #####  #  #  #   ######
#####  ## #   #  #####     #####  #  ##########
#####  ## #####  #  ## #   #  #####  ##########
#   #  ## #####  #  ## #####  #  ##############
#     ###       ##  ## #####  #  #  ###########
####       ###     ###       ##  #  #  ########
###  ##### ##  ##       ###     ##  #  ########
###  ##### ##  #  ##### ##  ##     ##  ########
###  #   # ##  #  ##### ##  #  ##     #########
######     #####  #   # ##  #  #  ##     ######
#########     #####     #####  #  ## #   ######
#####   # #   ########     #####  ## ##########
#####     ########   # #   ######### ##########
########     #####     #########   # ##########
#######  #   ########     ######     ##########
#######  ########### $#   #########     #######
#######  ########### .############  #   #######
#################### @############  ###########
##################################  ###########
###############################################
