########
##  #  #
##  #$ #
##  .*+#
#   #$ #
#   #  #
##  ####
##  ####
########
