##########
#@  ######
#  $ #   #
#.*.*. $ #
#  $ #####
##   #####
##########
