##########
### . ####
#  . $####
#  $$. ###
### .$$@ #
####$ .  #
#### . ###
##########
