#######
##  ###
##$   #
## .# #
##*.  #
# $ ###
# @ ###
#######
