#######
##   ##
# .$. #
# $#$ #
# .$. #
#    ##
## @###
#######
