######
##   #
##.# #
#  @ #
#  $ #
# #*##
#   ##
######
