#######
####  #
#  #  #
# . . #
# @$$ #
# # ###
#   ###
#######
