############
##  ##    ##
##     ##  #
## # $#  # #
## #  @ $# #
## #  #$   #
## ###  ####
## .   #####
#  .########
#  .########
############
