########
##   ###
## # ###
# $   ##
#  $#. #
## $ . #
##  #. #
##### @#
#####  #
########
