#########
#   #####
#  .#  ##
## ..  ##
## ## @ #
## #    #
## $ ####
## $#####
## $ ####
##   ####
#########
