###########
## ####   #
# ## ...# #
####$   # #
##  $$### #
## @      #
###########
