##############
##########   #
########## # #
#.     #  $  #
#.  @  #    ##
#.# #######  #
#         $$ #
##  #####    #
##############
