##########
## @ #####
#  #  . ##
# #      #
# $$ #.  #
##    ####
###   ####
##########
