######
##   #
## . #
#  * #
# # ##
#  $ #
## * #
## @ #
######
