###########
#####  ####
##     $ ##
##  $$ # ##
## # @#  ##
## ####  ##
#  ...    #
# ### #   #
#     #####
###########
