########
##    ##
##. ..##
###$ @ #
# $  $ #
#   ####
########
