########
####   #
##     #
# **$ ##
#  * .##
### #@##
###   ##
########
