############
#   ########
#   $ $ ####
## $    $ ##
####### .. #
######. . @#
######     #
########  ##
############
