##########
#  ##   ##
# $ $$*@ #
#  # . # #
## #. .  #
##   #####
##########
