#################
##     ######   #
##      @ ...   #
#  ########## ###
# $  $   $     ##
#  #   #   #   ##
#################
