###########
#####.#####
#### $ ####
###     ###
##  ***  ##
#.$ *@* $.#
##  ***  ##
###     ###
#### $ ####
#####.#####
###########
