#########
#####  ##
##     ##
##.# # ##
#@$ $#  #
# .$    #
##.$##  #
##. #####
#########
