#########
##     ##
#  $.$  #
# $#.#$ #
##..@.. #
# $#.#$ #
#  $.$  #
#   #  ##
#########
