############
# .  ###  ##
#      @  ##
#....# $#  #
###### $   #
#######$ $ #
#######   ##
####### $###
#######  ###
############
