############
##  #  #####
##  #  . ###
##   $ # @ #
### # $ $  #
### ##..####
###  #  ####
### ### ####
#     $   ##
#   ###.  ##
############
