########
##. . ##
##  *.##
###$ @ #
# $  $ #
#   ####
########
