##########
###   ####
##  # ####
##    ####
#  $ #####
#  $$#. ##
###$    ##
###  #  ##
######. ##
####@#. ##
####  .  #
####     #
##########
