########
#####  #
### .  #
##     #
# .$. ##
# $ ####
# .$####
###    #
###$#  #
##  #  #
##  @ ##
####  ##
########
