###########
######  ###
######  ###
##  $ $ ###
## .#  ####
## .#$$  ##
## .#     #
#  *###@  #
#        ##
## .#######
###########
