############
###   ######
###   ######
###  #######
###. # #####
#  . ###   #
#  . # $   #
# #.## $ $ #
#  . @  $$##
##  ###   ##
############
