#########
#   #####
# # $ ###
# # $   #
# #.$##@#
# #.$   #
#  .#####
## .  ###
##    ###
#########
