###############
## @  ######  #
##  #   $     #
## ....# $ #  #
#   ## ## $  ##
#      ### $ ##
###########  ##
###############
