#######
##   ##
##   ##
##$*$ #
##. . #
# .@.##
# $*$##
##   ##
##   ##
#######
