########
# @#####
#     ##
# .#.  #
##$$$$ #
# . .###
#    ###
########
