#######
##  ###
## *  #
## *#@#
## *  #
#  .$##
#    ##
#######
