########
####@ ##
##    ##
##$#.. #
#  $ # #
# # $  #
# ..#$##
##    ##
##  ####
########
