########
#    @ #
# $  $ #
## ## ##
# $# $##
#  .. ##
## .. ##
########
