########
#  #####
#...  ##
#.##  ##
#  $ $ #
###$ $ #
###@   #
########
