#########
#   .  ##
# $ #  ##
# ** ** #
##  # $ #
##  . @ #
#########
