###############################################
######   #######   #######   #######   ########
###### # #  #### # #  #### # #  #### # #  #####
######       ###       ###       ###       ####
######## #    #### #    #### #    #### #    ###
#######   #    ##   #    ##   #    ##   #    ##
#   ###    #    #    #    #    #    #    # $ ##
# # #  #    #    #    #    #    #    #    #  ##
#       #    #    #    #    #    #    #    ####
### #    #    #    #    #    #    #    #    ###
##   #    #    #    #    #    #    #    #    ##
##    #    #    #    #    #    #    #    #   ##
###    #    #    #    #    #    #    #    # ###
####    #    #    #    #    #    #    #       #
#####    #    #    #    #    #    #    #  # # #
######    #    #    #    #    #    #    ###   #
#   ###    #    #    #    #    #    #    ######
# # #  #    #    #    #    #    #    #    #####
#       #    #    #    #    #    #    #    ####
### #    #    #    #    #    #    #    #    ###
##   #    #    #    #    #    #    #    #    ##
##    #    #    #    #    #    #    #    #   ##
###    #    #    #    #    #    #    #    # ###
####    #    #    #    #    #    #    #       #
#####    #    #    #    #    #    #    #  # # #
######    #    #    #    #    #    #    ###   #
#   ###    #    #    #    #    #    #    ######
# # #  #    #    #    #    #    #    #    #####
#       #    #    #    #    #    #    #    ####
### #    #    #    #    #    #    #    #    ###
##   #    #    #    #    #    #    #    #    ##
##    #    #    #    #    #    #    #    #   ##
###    #    #    #    #    #    #    #    # ###
####    #    #    #    #    #    #    #       #
##  #    #    #    #    #    #    #    #  # # #
## . #    #    #    #    #    #    #    ###   #
##  @ #   ##    #   ##    #   ##    #   #######
###    # ####    # ####    # ####    # ########
####       ###       ###       ###       ######
#####  # # ####  # # ####  # # ####  # # ######
########   #######   #######   #######   ######
###############################################
