##########
#  ####  #
# $$  $$ #
# .$..$. #
## .  . ##
### @  ###
##########
