###########
#####  ####
##  # * ###
##.$#  * ##
#   @ * * #
#   #  *  #
######    #
#######  ##
###########
