########
#   ####
# #  ###
# #$.###
#  .$  #
# #$.# #
# #.$# #
#  $. @#
###.$# #
###  # #
####   #
########
