###############
#####  ########
#####  . ######
#####  $ ######
###### ########
######   ##   #
##  #  *      #
##.$# *@* #$.##
#      *  #  ##
#   ##   ######
######## ######
###### $  #####
###### .  #####
########  #####
###############
