###########
#   ###   #
#    ##   #
##    $$ ##
##  #  $ ##
####  #  ##
#### @#####
####    ###
#### ## ###
##    # ###
##.. .# ###
### ### ###
###     ###
###########
