################
#   .#  #  #####
#   .#    $#####
# @#.# $#  $ ###
#   .   # $   ##
#  ##### ##    #
#########    # #
######### #  # #
#########  ##  #
##########    ##
################
