########
#   ####
# .$. ##
# $*  ##
##  *$ #
## .$. #
####  @#
########
