###############
######   ######
#### $ # $ ####
#  #  $ $  #  #
#      #      #
#* ######### *#
#  ....@....  #
#* ######### *#
#      #      #
#  #  $ $  #  #
#### $ # $ ####
######   ######
###############
