###########
####   #  #
####      #
######$## #
##   # ## #
##   #  #.#
###  $  #.#
###  #  #.#
###$#####.#
### #  ## #
#        @#
# $##  #  #
#      ####
###########
