###########
####  #####
####  #####
####$. ####
### $.$$  #
#  ..@..  #
#  $$.$ ###
#### .$####
#####  ####
#####  ####
###########
