###########
###  ######
### $ $ ###
### #.#.###
#     #   #
# # #.#.# #
# # $ $ # #
#  #  # # #
##  #   # #
###  ###  #
####  @  ##
###########
