#########
#####   #
##   $  #
##  #$###
# * .  ##
#  * #@##
##  *  ##
## * .###
###   ###
#########
