#########
#####   #
##   $  #
##  #$###
# * .  ##
#  * #@##
### .  ##
###  ####
#########
