###########
####   ####
#### .$####
####$. ####
# $ $.$$  #
# ...@... #
#  $$.$ $ #
#### .$####
####$. ####
####   ####
###########
