#########
#####   #
##   $  #
##  #$###
# * .  ##
#  * #@##
##  *  ##
## . ####
###  ####
#########
