'LOMA#3a'
#########
###  ####
## . ####
## * ####
## *#####
#  $ ####
#  @ ####
#  ######
#########
