'LOMA#1d'
#########
###  ####
###  ####
###$.####
#  $.####
# #$. ###
#   @ ###
#########
