'LOMA#2a'
#########
#   #####
# #$.  ##
#  .$#@##
###$.  ##
###  ####
###  ####
#########
