'LOMA#2b'
#########
###    ##
#   ## ##
# #$.  ##
#@#.$####
# #$.####
#     ###
###   ###
#########
