'LOMA#3b'
#########
#  ######
#     ###
#  .# ###
###*# ###
##@*   ##
## $   ##
####  ###
#########
