'LOMA#4d'
#########
####  ###
## . @###
## $  ###
###* ####
#  $ ####
# #. ####
#   #####
##  #####
#########
