'LOMA#4a'
#########
#   #####
#  . ####
#  $ ####
## * @ ##
###$ # ##
###.#  ##
###   ###
#########
