'LOMA#3d'
#########
## .  ###
## *# ###
##@*  ###
## * ####
###$  ###
##    ###
## # ####
##   ####
#########
