'LOMA#5b'
#########
#  @#####
# #$$  ##
#  $.# ##
###..  ##
####   ##
#########
