'LOMA#3c'
#########
## . ####
## * ####
## * ####
#  * ####
# @$ ####
#  ######
#########
