#########
##  #####
##$   $ #
## .#.  #
## ### ##
# $.#. ##
# @   $##
#####  ##
#########
