'LOMA#7d'#
##########
###  #####
###      #
### ###  #
# @$  #  #
# $*. # ##
###.### ##
##      ##
##   #  ##
##########
