'LOMA#6d'
### #####
#####   #
### $ # #
# @.*.  #
# # $ ###
#   #####
#########
