'LOMA#7c'#
##########
###      #
### #### #
#  @$  # #
#  $*. # #
#  #.### #
#  #     #
##########
