'LOMA#9b'
#########
#   #####
#   #   #
## $*@  #
## *.  ##
##  #####
#########
