'LOMA#9d'
#########
######  #
#  ##   #
#   $*  #
#  #*. ##
##  @ ###
##  #####
#########
