'LOMA#10a'
#### #####
#@ ### ###
# $$ #####
# $ .  ###
## ..  ###
##########
