'LOMA#9c'
#########
###@ ####
###  ####
###$* ###
#  *.  ##
#      ##
#####  ##
#########
