##############
##  ####  ####
##    #  $   #
## #  #  ### #
#  # ###   #.#
#  #     $ #.#
#  #  ###  # #
## #  # ## #@#
#  ####  # # #
#        # #.#
#  ##### ###.#
###### #$$ # #
######       #
######   #   #
##############
