############
###  ####  #
#  $   . . #
# $ $   #  #
### #### . #
## @     ###
##   #######
############
