##################
##  ##############
##      #####  ###
## ###$ #####  ###
## # #. . .   @ ##
## ####$#####    #
## #### ######   #
#  #  $  #########
#        #########
#####  ###########
##################
