######################
#### .################
###        ###########
## ...###  ###########
##   #### #######  ###
#    #### ##### $$   #
#   ##### ####  @$   #
#########       $##  #
#########  #####    ##
######################
