###############
###############
###############
######   ######
#####  . ######
##### $*$  ####
###  $#.#$  ###
### .*.@.*. ###
###  $#.#$  ###
####  $*$ #####
###### .  #####
######   ######
###############
###############
###############
