############
######  ####
##  $   ####
##  # #$####
###. . .####
###$# #$####
###. . .   #
###$# # @  #
###   $  ###
###  #######
############
