##########
###  #####
###      #
## .**$  #
## #  #@##
#  $**. ##
#      ###
#####  ###
##########
