########
###  ###
## * ###
#  $  ##
#@#$# ##
# .$. .#
###    #
###  ###
########
