#########
#  ######
#     ###
#  #$ . #
## #.#$ #
#  # @* #
#   *  ##
####  ###
#########
