#########
####   ##
####. $##
#### $ ##
####.. ##
# $ **  #
# .  @$ #
#########
