########
#    ###
# .* ###
# .$.$ #
## $  @#
#####  #
########
