############
##  ########
## $## @ ###
##. ##  .  #
# .    $.$ #
# *$ #$#.###
###  #   ###
############
