########
##@ ####
# $* * #
#  * # #
#  *   #
# #*.  #
#   #  #
########
