###################
#   ...  @  ...   #
# $$$  #####  $$$ #
##   #########   ##
###  ##########  ##
###################
