#########
#####  ##
# $ .  ##
#   *$ ##
###..$ ##
####@####
## $. ###
## $*.  #
##  . $ #
##  #####
#########
