#########
###   ###
##  $..##
##$ #.$.#
#   #...#
# $###$ #
#  $ $ ##
##@    ##
#########
