#########
### @ ###
### # ###
# $$#$$ #
# .. .  #
##  #.$##
##   . ##
#########
