##########
###   ####
###$   $ #
#  $ #   #
# # .## ##
#.**.##$##
# @ .   ##
##########
