##########
###  . ###
# $.$$$  #
# # #. # #
# @. . # #
#### $   #
####$.####
####  ####
##########
