#########
###   ###
#  $..$ #
# # ##  #
# # ##@##
#  $..$##
### #$ ##
### . .##
###$# .##
###  $ ##
#####  ##
#########
