#########
###     #
### ### #
#  *$  .#
#  * $#.#
## *@$ .#
##$$* . #
## # .###
## ## ###
##    ###
#########
