########
####  ##
# .$* ##
#   $  #
# .# . #
# *#$@##
##    ##
########
