########
#   *  #
# * .  #
# *** ##
# $ * ##
## @  ##
########
