#######
#    ##
#    ##
##$ ###
# $   #
#.***.#
#  @  #
#######
