#############
#@$   ....###
# $$$$#....##
# $  $..***##
##   # ##.. #
# $$$#  ##  #
#    ## #  ##
#  $$ #    ##
#     ###  ##
#############
