#########
##    ###
#  ##  ##
# #  # ##
#.  .#$##
# # * $ #
# # * $@#
#  .. $ #
#########
