###############
#   ##..  #####
# $ ....# #####
#  #.... @ ####
#  #.#.. #   ##
####.###  $# ##
###  ##  $ # ##
##   #  #$    #
#  $ #$$#   # #
# # $  $ ##   #
# ###$ $  $  ##
# $    ##    ##
# $   ####   ##
#  ############
###############
