#############
##  #####   #
##*   * #$# #
#   #   #   #
# * . *  ** #
######   #@##
# .   ###   #
# $ *    *# #
##*   * **  #
##  ####    #
#############
