##############
####...#######
####...#    ##
####...$ $$ ##
#####.. @# ###
#    $ ### ###
#   #$####   #
## $     ### #
##   # $  $  #
#######  # $ #
######  $#$# #
######       #
##############
