###########
#### @ ####
####$$$####
#### . ####
#   *.* $ #
# $.....$ #
# $ *.*   #
#### . ####
#### $$####
####   ####
###########
