###########
#    .    #
#  $.$.$  #
###.$.$.###
####.$.####
####$.$####
#### $ ####
#### @ ####
###########
