##########
###. #####
###$ ###.#
#  .$.   #
#   ##$$ #
# $$.#@  #
#  $.#####
###   .###
##########
