################
#####     ######
#####  $$  #####
###### #  $#...#
#### $ #  $ ...#
##     ## $#...#
## $ #$    #...#
## #  $ # $ ...#
##  $ $##$  #  #
## ##$ #@ ######
# $    #########
#   #  #########
################
