###############
########   ####
#.....# $# ####
#.....   # ####
#...  # $# ####
##### #  #   ##
#####   $#$# ##
#######$ $ # ##
#######   $@$ #
#######   # $ #
#######$ $$$  #
#######       #
###############
