#########
#   #####
# $ #   #
#   #$# #
###$    #
##   ####
## @...##
#########
