################
####......######
###@..$ **.#####
###  $ $      ##
######### #$#  #
####### $ $  $ #
####### #  # # #
#######  #   $ #
########  $##  #
#########     ##
################
