#########
#   @...#
# #$#.*.#
# $  $$ #
## #$   #
##   ####
#########
