#########
###  ####
### $####
#@$.. $ #
#  .*   #
###  ####
###  ####
#########
