###########
######    #
# $ .*. $ #
#@$.* *.$ #
# $ .*. $ #
#     #####
###########
