##############
######  ######
######      ##
##  ## ##   ##
##   $   #$$ #
#  ####  # $ #
#  ..##$#    #
###... $ # # #
###.*.#$ #$  #
###...#  # $##
#######$    ##
######@  #####
##############
