################
#  #############
# $$ $ #########
#        ##  ###
### ####$# $ $ #
#....        $ #
#....####$ #   #
#....###  ## $ #
##.#### $ $@$# #
##    $   #    #
##  #    #######
################
