###############
###########  ##
#      $   $ ##
#  ##### ### ##
## # $...$ # ##
## # $...     #
## #@#...###$ #
## ## ...    ##
#  $ $$$ ######
# $$   ########
#      ########
###############
