###############
###########   #
#########   $ #
#####   # $#$##
#....$ $#     #
#....$#   $ $ #
#....@#  ###$##
#....#   $    #
## #$ $ $ #   #
# $$ #$########
#      ########
###   #########
###############
