###########
###      @#
###$ $ $  #
### ##$# ##
###.. .. ##
## .. ..###
## #$## ###
#  $ $ $###
#       ###
###########
