###############
#    ##########
# $$$#    #####
# @$ # ## #####
# $$....# #####
#  #.#.*# #   #
#  #.#*.$     #
#  #.*.. ###$##
#######$#  #  #
####### $$    #
#######    #  #
#######  ######
###############
