###############
####  #########
####  $ #######
#    $# #  ####
# $#  #   @####
#    #  #  ####
# #$ $ #..... #
# $ # $ ..##. #
##$  # #...*.##
##  $#  #..#. #
## $  #$$  $$ #
##  # $    #  #
#####    ######
###############
