##############
#####  ....###
##### #....###
##  # $...####
#  $ #$.*. ###
#    $ $# $$ #
# $#  @ #    #
##  #  #  $ ##
##  $ # $ ####
##  #  $ $####
######    ####
##############
