########
#   @  #
# #$## #
# $  $ #
###  $##
##. $.##
##. ..##
########
