###########
#   #######
# $ * .$  #
# #.#.#.# #
# $ $@$ $ #
# #.#.#.# #
#  $. * $ #
###   #   #
###########
