#########
##  *  ##
# . .@. #
#   * $ #
#*$$*$$*#
# $ *   #
# . . . #
##  *  ##
#########
