##########
#    $  .#
#  $##$# #
#   $    #
### ## ###
#  $#  ###
#.*.  $@##
#...##  ##
##########
