##########
#.     $.#
# #### #.#
#. $ #$  #
#  $ # $ #
#   $@ $##
######...#
##########
