##########
##  @#  ##
#  ###$ ##
#  * *   #
# * * *  #
#  * * . #
###   ####
##########
