################
#############  #
##      $      #
##$$#  ## ###  #
##  ## #....# ##
#  $   #....$  #
#@#$$ ##....#  #
# $    #....#  #
##  $$ ###$### #
## $ $ #       #
##$ $ $  #   # #
##  ## #####   #
##     #########
################
