###############
##  #####  ####
# $ $   $$ ####
#    ## #  ####
##$#.....$   ##
## #.....#  $##
## #.....# $$ #
## ### ###    #
##    @    #$ #
##  #  $ ###  #
##### $ $ $ $ #
#########     #
###############
