###############
####@      ####
#### ##  # ####
## $$ # $#  ###
##    # $ #$ ##
##  # # #    ##
### # $  $ $ ##
### #   ###  ##
### ##...##$  #
###$$ ..### # #
#  $  ...##   #
#   ##....#####
###############
