################
##  ############
##   $     #####
## ##$ ###   ###
##    #...$  ###
##$ @ #...# $ ##
##  #  ...#$   #
# $$  $#..  #  #
# #  $ #..$ $  #
#  $  ##..#  ###
### #$  $ ######
###    #  ######
################
