#############
###  ########
###    $    #
## $# #.# # #
##  ...*. $ #
## #$##.##  #
# $     $ @ #
#   ###  #  #
#############
