#############
#   #########
#   # .    ##
#  ## *$$#  #
# @ # .   $ #
#   # .#$#  #
##  ##.# $ ##
##  ##.#   ##
##   #. # ###
##   $* # $ #
##    . #   #
#############
