################
######   #######
#   #  $ ##   ##
# $ $ $ #   $ ##
#  $# @ $ $$#  #
## $  #     $$ #
#..#$#### #$#  #
#....  #  #   ##
#....   $$######
#...###   ######
#...############
################
