###########
###   #####
### . #####
#   . #####
# ##$## @ #
#   . $   #
###$.$#####
###   #####
###########
