#############
##### @######
##  #   #  ##
##$ $ $$$ $##
##  #.#.#  ##
## #.....# ##
## #.....# ##
#   #...#   #
# $  # #  $ #
##  $ $ $  ##
###$ $ $ $###
###       ###
#############
