###############
###############
###############
###########   #
########### # #
### $ $ $ $   #
### # # # #$###
###.......   ##
### #.#.#.#@$##
### $ $ $ $   #
########### # #
###########   #
###############
###############
###############
