###############
#########  ####
####  $ $  ####
#### *.*.* ####
#### .$ $. ####
#### *.*.* ####
####  $ $  ####
###### @ ######
###############
###############
