###########
#         #
#  # $ #  #
#  .$ $.  #
# ..#$ #. #
#  .$ $.  #
#  # $ #  #
#@        #
###########
