######
##  ##
#    #
#.$$.#
#    #
##@###
######
