##########
##    ####
#  $ $ ###
# $#  $ ##
#  ## . .#
##  #  . #
##$ ##. .#
##  @#####
##########
##########
##########
