########
#  #####
#  #  ##
#@$    #
##. $  #
##.$####
##. ####
########
