########
#      #
# $ $  #
#@ $##.#
##   #.#
### $ .#
####  .#
########
