#######
#   ###
#@$  ##
## $  #
### $ #
####  #
#####.#
#####.#
#####.#
#######
