#########
###### .#
#####   #
####  $ #
### .$ .#
##  $  ##
#. $ @###
# $  ####
#   #####
#. ######
#########
