######
# .###
#  ###
#@ $ #
##$#.#
#  $ #
#    #
# .###
######
