#########
##      #
### *   #
###*.* ##
# $ * ###
#      @#
#########
