#######
#     #
#@ *  #
## $  #
## ** #
## .* #
## *  #
##    #
#######
