##########
#####  ###
#        #
# #$# #$ #
# $  $   #
#.###  ###
#.########
#.########
#+########
##########
