##################
#      #  #      #
#  *   #  #   *  #
# *.*  $  $  *.* #
#  *.* #  # *.*  #
#      # @#      #
########  ########
#      $  $      #
#                #
##################
