########
#      #
# $* $ #
# *.*  #
# .* ###
# * ####
#  #####
#@######
########
