#########
#@#######
#  ####.#
#   ### #
# $  ## #
## $  #.#
### $   #
#### $  #
##### #.#
####### #
#######.#
#########
