############
#@##########
# ##########
#   ########
# $  #######
## $  ######
### $      #
#### $ *.* #
##### *.*. #
#####  *.* #
#####      #
############
