#########
###   ###
#   $  @#
#  $ $ ##
# * * ###
# .*#####
# *.#####
# .*#####
# * #####
# #######
#########
