#########
#       #
# * @   #
# .*# $ #
# *.#$$ #
# .*# $ #
# *.    #
#       #
#########
