########
##    ##
##  $  #
#  *#* #
# *.*. #
#  * * #
#  $####
#@  ####
##  ####
########
