##############
#@############
#  ##   ######
#  $ $  ######
# $ $ $ ######
## $ $  ######
### $ $ ######
#### $# ######
#####   ######
####### ######
####### ######
####### ######
####### ######
##. . # # . .#
## .       . #
##. .     . .#
##           #
##############
