#########
### #####
##   . ##
#   ##  #
# # .$$ #
# # ##  #
#  $ . ##
##    ###
###@#####
#########
