########
####  ##
####  ##
####  ##
#  # ###
#@  $ ##
###  $##
####. .#
########
