#########
##   ####
##  $ ###
###$#  ##
##  #   #
##  $ $ #
#. $# #.#
#.  #$#.#
#.  @  .#
#########
