#########################
#################  ######
#   #########   #     ###
# # #         # # ### ###
#     $ #       #  .# ###
#####  $### ###   .## ###
######$ ###        .# # #
######@######### ####   #
################ #   # ##
################   #   ##
#########################
