#############################
##  ##   #########          #
#        #       ##         #
#   #### # ####$ $  # ##    #
## ####     $    #$ #  # ## #
##      $ ######       # ## #
##  #  ####    ###### ##    #
## ## $#    #     $    # ## #
##  #  #  #   # # ## # # ## #
##$ #### $# # # #  #   #    #
##        #  .       # # ## #
##  #    $##.#. #$ .   # ## #
########     .  #  # ###    #
########       ##$ # #      #
##############    ## #      #
##############@    $ # ##...#
################ $  ##  #...#
#################  ##.  #####
####################..  #####
#############################
