#########################
#############  #  #######
#######  ####  #        #
########  $    # #   #  #
#     .# $$$##$#.##### ##
#           #  # #   #  #
#  ###.# ####$     .    #
########  . $   ####  $##
#######@  #    ######  ##
#########... ############
#########################
