#####################
#                   #
#          @        #
# $#. #$## #. $###  #
#  # .# #  #.  # #  #
#  #. # #  #. $# #  #
# $#### ##$#.  ###$ #
#  #. # #  #. $# $  #
#  # .# #  #.. #  $ #
# $#. # ## ###$# $  #
#                   #
#                   #
#####################
