###################
###########       #
###      $    $   #
### ##   #  ###$# #
# .  # $###$  # # #
#. . #   $        #
### ## ####### #  #
###  #    #    #  #
###  # ## #  ###  #
###       .       #
###  ####.@.#######
###################
