######################
#                    #
#         #  # # # # #
# ## ###.+# ## $ $ $ #
# ##  #..##  $ # #$# #
#     ..##  ## ### $ #
#                    #
###  #####  #####  ###
######################
