#################
##      #       #
##$  $ ###$# $# #
##  ##  #  ## $@#
## ## $        ##
#. .#  $ ########
#.   $ ##########
##.   ###########
###..############
###..############
#################
