#########
####    #
###   @ #
#   $## #
# $   # #
# ##  # #
# ## ## #
# $  #  #
# #  $  #
######..#
######..#
#########
