########
##  ####
#   $  #
# $$#@ #
# $ ## #
#    #.#
## $ ..#
###  ..#
########
