###########################
###################   #   #
#           ##    #       #
#  #   ##  ##     ###  #  #
# ## $ #  ##    #   #  #  #
#   $$$  ##    ## # # ##  #
#### $  ##    ##    #  #  #
###    ##    ##    ## ##  #
##    ##    ##    ##   #  #
#    ##    ##    ##    #  #
#   ##    ##    ##    ##  #
#  ##    ##    ##    ##   #
#  #    ##    ##    ##    #
#      ##    ##    ##  #  #
#     ##    ##    ##   #  #
##   ##    ##    ## ##.   #
### ##    ##    ##  ...#  #
#####   ###    ##   ##+#  #
#####         ##     ###  #
#######      ##           #
##############            #
###########################
