#############################
########   ##################
######## .                 ##
#..##### #   $  $  ####  $ ##
#..#####     #  #  #  $ #####
#..  ..#  $ ######$#  #$#   #
#   $..#$##  #  #  # ##     #
### #..#  #        #    ## ##
### ####  ########## # ## $##
### $  $  #  #     # ### $ ##
###      ##  #  ## #        #
########### ### #  #######  #
####  #   #   # # ##   #    #
####  # # # #   #  # # # # ##
####    #   ######   #   # ##
#### ########   #############
####  #   #   #  #   #   # @#
#####   #   ####   #   #   ##
#############################
