###########
########  #
########$ #
#  $      #
#  #####$ #
#         #
#  #####  #
#     .#  #
#    .##  #
#  #.##   #
#@  ##    #
##       ##
###########
