##############
#########    #
#    ####  $ #
# #    #  ## #
#.$.#$     $ #
# .   $ $ ## #
#. .#####$ $ #
# . #####    #
#.$.##########
##+###########
##############
