##############
####  ########
#### $########
#@    $  #####
##    #. #####
##  $## .#####
###   #.     #
###          #
####    ###  #
##############
