##############
#########  ###
#######   $ ##
######   $  ##
###   $  #$ ##
### $ #$##   #
# @ #       ##
# # ## #    ##
#   ..    ####
###.... ######
##############
