#############
###    ######
## $ $  #####
#  # #  #   #
#   # .  $ @#
# $# .$ $# ##
#  .  .    ##
# .$.########
## . ########
#############
