##########
#       ##
# ## $  ##
#  #$## ##
## $    ##
## #######
#  #  # ##
#    .  ##
#### # ###
###  #   #
### .@.  #
##########
