############
#######   ##
##        .#
##  #### ..#
###$#  ##..#
#    $  ##.#
#   $#$  ###
## # $   $@#
####     ###
############
