###########
####  #  ##
####      #
###   #   #
##    ##  #
#  $#. . @#
# $ # *  ##
#   #######
###########
