##################
#    #############
# $ @#############
#  $####  ########
# $ $  #$    #####
#  $ $   $  ..####
# $  #  $  #.  ###
#   ######   ...##
############.. ..#
##################
