##############
####    ######
#### ## ######
#            #
#   $ # $ ## #
# $ # $ ###  #
#  #  #      #
#  $ #########
##$# #     ..#
##         ..#
###########.+#
##############
