###############
###   #    ####
#     $       #
#  $### $  #@ #
# $   # # ### #
# #$  #   #   #
#   .  * $  ###
###.#. #.#  ###
### .  . ######
###############
