#####################
#####        ########
####     $ $    #####
###     ######$     #
##    ###    #  # # #
#     #    # ####$  #
# # $ #    $ #. #   #
# # ###  ### # .##  #
#     $    #  .  #$ #
####  #  *     . #  #
# #  ### # ##  #### #
#      #.#. ## #. ###
##   $ # .   ##. .###
## $ ###   $  $ . ###
## # #.   ##$ #  ####
#@   # .   #    #####
#####################
