############
##      ####
#  #  #    #
# ###  $   #
#  #  .#.  #
#   $ ###  #
## $#$.#.  #
###        #
######  @###
############
