###############
#####         #
#### $       @#
### $  ########
## $  ##      #
# $  ##  #  # #
#   ##  ### # #
##  $      . .#
##########  . #
###########. .#
###############
