##################
########+   ##   #
##     ##        #
#       ##  # # ##
#  ##    ##   ####
##  ##    ##  # ##
##$  ##    #  # ##
## $  ##   ##   ##
### $  ##       ##
#### $  ##  # . ##
##### $  ####.#.##
######     #  . ##
##########    ####
##################
