#############
####  #     #
#         #@#
#  #.. .#####
## ######   #
#           #
#  #    # # #
## # ####   #
#  ###    # #
#   ##      #
##   #$#$#  #
###    $ ####
####     ####
#############
