##################
#######    #######
######         ###
#####    ##     ##
####    ##  #    #
###    ##   $ #  #
##    ##    # $  #
##   ##  #    #  #
#   ## $  $  $   #
#   #  #  #  #   #
#@  #          $ #
##  ######  #  # #
##   #  #  ###   #
##   #. .   .#####
##      #  . #####
##      #   .#####
######  .  #######
##################
