#####################
##########  #########
####        #########
####   $ #  #########
#     $  #  #########
#    $ $##  #########
#   # $  #   #   ####
#  ### $ # .   .  ###
#   # $  #.#. .#.   #
#     #$ # .   .   @#
#        ############
#####################
