#############
####        #
####  #   # #
#### ## $ $ #
####$#  #   #
###  ## # $ #
###  $ $  ###
###  # #  ###
#       $ ###
#   $ #######
#  ####. .###
#  . .# . ###
#@  .      ##
###. .#  # ##
#############
