#############
######      #
##### $  #  #
###   # $   #
#..  $  #$  #
#+.  #      #
####   ######
###   #######
#############
