##############
######      ##
####  $ $   ##
###  $ ###  ##
### $    #  ##
###### #    ##
###. # #   ###
# ...# $ # ###
# #. ###   ###
#          ###
##   #   #   #
####   #   #@#
##############
