#########
#####  .#
#   $   #
# # # # #
#   $   #
#####. @#
#########
