################
##     @  ######
##     #   #   #
##  # ###    $ #
##  #  # $ $ ###
##  #    #$# ###
##  #      $ ###
### ##  # #  ###
##.$.###########
## .    . ######
###    . .######
#####   ########
################
