#############
# ...... ####
# .##### ####
##  #  #$####
#  ##$    ###
##     # $ ##
#  # ### # @#
##     #$$ ##
###  #   $ ##
####    $# ##
########   ##
#############
