###############
########### # #
##      ###   #
##   $  ##  $ #
###$### ###$# #
##   #  ##    #
## # #$    $ ##
####    ##  ###
###  ####  ####
#.  . .#  $ ###
##  # ## $ ####
#.  . .#  #####
###.@.#########
###############
