################
#####    #######
##### ## #######
#####  $    ####
#   # ##$## ####
#  $     $  ####
#  # $   #$ ####
## #### ##     #
## #..# $  # $ #
## #..####   # #
#  #..#  # $ $ #
#  ...#  #$#$  #
#  ...#    $   #
####.+#  $   # #
#######  # ### #
##########     #
################
