#############
###      ####
##**. #   ###
# .#.### $ ##
# ... #  #  #
#  # $  $#$ #
##   # $ $ @#
## # ##    ##
##    # #  ##
#############
