#########
#   @   #
#   $   #
# * # * #
#.#.#.#.#
# .$#$. #
# $ $ $ #
#       #
#########
