#########
#####  ##
##### $ #
#  $  # #
#  #  $ #
# ###   #
# .#   ##
# .. $ ##
#.$######
#@.######
#########
