########
#@######
#      #
# ###$ #
# #  $ #
# .  $ #
#.#  ###
# .  ###
########
