#########
###     #
### # # #
###   $ #
## $  #.#
#  # ##.#
#  $  $.#
#  # ##.#
# ##$ #.#
#  @    #
#########
