###########
###   @ ###
#  $ ##$  #
# $.## .$ #
#  $ . $  #
###. . .###
###########
