#######
#    ##
#     #
##$# ##
#  $  #
# ##. #
# #.  #
#    ##
##@####
#######
