##########
###    ###
###  . ###
###@.#.  #
#### . # #
#   $  # #
# $ #  $ #
#  ##  ###
# ##   ###
# # $ ####
#     ####
##########
