#######
###   #
##  $@#
#. $ ##
#.$ ###
#. ####
#######
