############
#####   @ ##
####    #  #
###   #    #
##  $####  #
#  $$ # #.##
# $ #    .##
#  ##   #.##
#      ##.##
######    ##
############
