#########
##     ##
#   $  ##
#.  #  .#
# $###$ #
#.  #  .#
#   $  ##
##  @  ##
#########
