#######
##    #
## $  #
#  ##$#
# $.#.#
# $...#
# $####
#@ ####
#######
