#######
###   #
## .$ #
# $## #
#   . #
# $## #
#  . @#
#######
