########
#####. #
####.$.#
### $. #
## $  ##
# $  ###
#@  ####
########
