###########
##      # #
#   $   $ #
#  ##  ##.#
#   ##  #.#
#@   ##$#.#
##        #
########  #
###########
