######
###  #
## $ #
#.$ @#
#$. ##
#. ###
######
