#######
#     #
# $## #
#  $  #
## #$ #
#  #  #
# .####
#.$.###
# . ###
## @###
#######
