############
##  ########
##$ #      #
##      ## #
# .$#@#    #
#.$ ########
# .#########
############
