#############
###  ###  ###
###   $   ###
#   $###$   #
# ##  #  ## #
#     # #   #
###@  #   ###
####. . .####
#############
