######
##   #
## $ #
## @ #
###$##
##.  #
#.$  #
#  . #
######
