#########
#       #
# .$$$. #
#  .$.  #
# .$@$. #
# $...$ #
#  $.$  #
#       #
#########
