#########
#       #
#  ..*  #
#  * $  #
# $.$   #
# $+$   #
#  * $  #
#  ..*  #
#       #
#########
