#########
#       #
# $..$$ #
# #.$.  #
# $.#+$ #
# #.$.  #
# $..$$ #
#       #
#########
