#########
#       #
# $.*.$ #
#  .$.$ #
# #.*@# #
# $.$.  #
# $.$.$ #
#       #
#########
