##########
####   ###
### . $ ##
#  .#* $ #
#  . $@  #
#  .#* $ #
### . $ ##
####   ###
##########
