###############
## ##     ## ##
#  $.$.$.$.$  #
##  $.#+#.$  ##
##   *.$.*   ##
####  $.$  ####
#####     #####
###############
