##########
##   #  ##
## *  * ##
#  . *   #
# $.*@$$ #
#  . *   #
## *  * ##
##   #  ##
##########
