##########
#        #
# $$$#$# #
# ..$. . #
# ###$$$ #
# #..+.# #
#        #
##########
