###########
#  . . .  #
# . . . . #
#######   #
#    $ $  #
#       # #
###$####  #
#@ $   #$ #
### $  $  #
#####     #
###########
