##########
#        #
# $$.### #
# .   .# #
# ###$$$ #
# #.. @# #
#        #
##########
