#######
##. .##
#. . .#
#. $ .#
##   ##
## . ##
### ###
#   $ #
# $$$ #
# $@$ #
#  $  #
##   ##
#######
