##########
#        #
# $$$# # #
# ..$. . #
# ##$$$$ #
# #..+.# #
#        #
##########
