###########
# . . . . #
#  . . .  #
#######$  #
#    $ $  #
#       # #
###$####  #
#@   $ #  #
### $ $   #
#####     #
###########
