#######
##...##
# . . #
#  .  #
##   ##
### ###
##   ##
#  $  #
#  $  #
# $$$ #
#  $  #
## @ ##
#######
