##########
#        #
# .$$#$# #
# . $  . #
# ###$$$ #
# #..+.# #
#        #
##########
