##########
#        #
# $ $. . #
#  $  .  #
# $#$. . #
# . .$#$ #
#  .  $  #
# . .$ $ #
#@       #
##########
