#######
##   ##
#     #
#.....#
## . ##
### ###
##   ##
#  $  #
# $$$ #
#  @  #
# $ $ #
##   ##
#######
