####################
#    #    ##       #
# $$$#   #  #  # $ #
#            #     #
### ##   #$$     ###
#        #   #  # .#
#         ###  #. .#
#              #. .#
#    ##  #     #. .#
#     # ##     #   #
# #            #   #
### ##  ###        #
# $  #     #      ##
#          @####   #
####################
