##########
#        #
## *.$ # #
##.##  . #
##.#.$$$ #
# $@.  # #
#  $## $ #
##    $  #
#  ###  ##
#  ..#####
##########
