###############
#             #
# ...    $ $  #
#   .   $###$ #
#   ...  #@  ##
#     . $###  #
# # ##...   $ #
# $ $  #.$ #  #
#  $ $ #$. #$ #
#             #
###############
