####################
#    #    ##   #   #
# $$$#   #     # $ #
#            #     #
### ##   #$$     ###
#        #   #  # .#
# $       ###  #. .#
# $            #. .#
# $  ##  #     #. .#
# $   # ##     #. .#
# #            #. .#
### ##  ###        #
# $  #$$ $ ##     ##
#          @####...#
####################
