##########
#        #
## *.$ # #
##.###   #
##.# $ $ #
# $@.$ # #
#  $## $ #
### ##$  #
#...    ##
#.      ##
##########
