##########
#        #
## * $## #
##.##  . #
##.#.$$$ #
# $@.    #
#  $## $ #
##    $  #
#  ###  ##
# ...#####
##########
