##########
#        #
## $   # #
## ###   #
## # $ $ #
# $@ $ # #
#  $## $ #
### ##$. #
#...... ##
#.      ##
##########
