##############
# @#       ###
# $#  ##...###
#  #    #..$ #
## #$# $#   .#
## $    #  ###
#  $### ## $ #
#  $     $   #
#  $ ## $  ###
## # ##### ###
#  $    .....#
#    ##   .  #
##############
