##########
#        #
## * $#$ #
##.##  . #
##.#.$$# #
# $@.    #
#  $## $ #
##    $  #
#  ###. ##
#  ..#####
##########
