##################
#                #
# $        # $   #
#  ##### $ #     #
#          #$ #  #
#  ##$##      #  #
#       . $   #  #
# #$   ... ## #  #
# #     .  #  $  #
#    $  .  #$    #
# $    ... #     #
#     .   .   #  #
# ##$#.#  .  ##$ #
#                #
# #  # #   # #@# #
##################
