##########
#        #
## $.$.# #
## ###   #
## # $ $ #
# $@.$ # #
#  $## $ #
### ##$  #
#.....  ##
#.      ##
##########
