###############
#             #
# ##$$#       #
#     #  #.   #
# #$$    .#.  #
# $  ###   #  #
# $           #
#  #  #  #.#  #
# #  @#  .#.  #
#             #
###############
