##########
#        #
## *.$ # #
##.###   #
##.#.$ $ #
# $@.  # #
#  $##$$ #
###   $  #
#.   # .##
#.   #####
##########
