##########
#        #
## $   # #
## ###   #
## #.$ $ #
# $@ $ # #
#  $## $ #
### ##$  #
#...... ##
#  .    ##
##########
