##########
#        #
## *.$ # #
##.###   #
##.#.$ $ #
# $@.$ # #
#  $## $ #
### ##$  #
#..     ##
#.      ##
##########
