############
#       ####
# $ #$#... #
# .## ##$  #
# $@$      #
# .## ##$  #
# $ #$#... #
#       ####
############
