############
#      #####
# $ #$$##..#
#  #    .. #
#  @$ $#   #
#  #    .. #
# $ #$$##..#
#      #####
############
