########
#. $   #
#.$ $$.#
#. $@$.#
#.     #
########
