############
#       ####
#   #$#..  #
# .## ##$  #
# $@$      #
# .## ##$  #
#   #$#..  #
#       ####
############
