##############
#     ########
#     ########
# #$# ### .  #
# $@$    . . #
# #$# ### .  #
#     ########
#     ########
##############
