############
#      #####
# $ #$$##..#
#  #   .   #
#  @$.$#.  #
#  #   .   #
# $ #$$##..#
#      #####
############
