########
#     @#
# *$$$ #
# ...* #
#      #
########
