############
#          #
# $$ # ##. #
#  ##  #.. #
#   $ $ #. #
# #$##  $. #
# $ @# $#. #
# $ $   #. #
#   #  #...#
#  #       #
# #     #  #
#  ###     #
############
