##############
#       ######
# $ $ # .#####
# #$# ##  . .#
# $@$    . . #
# #$# ##  . .#
# $ $ # .#####
#       ######
##############
