#######
# .#. #
#  $  #
#.$ $.#
# $@$ #
#.$ $.#
#  $  #
# .#. #
#######
