############
#          #
# ###$$### #
#  # .. #  #
#   .  .   #
# $  ##. $ #
# $  ..  $ #
# $# ##.#$ #
# $ .  . $ #
#  # .. #  #
# ## $$ ## #
#         @#
############
