#############
###       ###
### #   # ###
#    # #    #
# $$$ $ $$$ #
#    #@#    #
### #   # ###
##   . .   ##
##  . . .  ##
##   . .   ##
##         ##
#############
