############
#          #
# $$ #.#.. #
#  ##  #.. #
#   $ $##  #
# #$##  $  #
# $ ## $#. #
# * $   #  #
#  .# $#.. #
# .# $ .#  #
# #        #
#  ###    @#
############
