############
#          #
# #  .  #$ #
#  #.$.#   #
#  $.$.$ $ #
# $  .  $  #
#  $.@.$   #
# #. $ .#$ #
# $ ...    #
############
