##############
#       ######
# $ #$# .#####
#  ## ##  .  #
# $@ $   . . #
#  ## ##  .  #
# $ #$# .#####
#       ######
##############
