############
#       ####
# $ #.   ###
#  ## .    #
# $@ $ . $ #
#  ## .    #
# $ #.   ###
#       ####
############
