#############
##. .###. .##
#.   .#.   .#
##   #@#   ##
### #   # ###
##  $ $ $  ##
##  # # #  ##
## $     $ ##
##  $ $ $  ##
####     ####
#############
