###########
#       ###
# $ #.   ##
#  ## .$  #
# $@ $..  #
#  ## .$  #
# $ #.   ##
#       ###
###########
