############
#      #####
# $ #$ ##. #
#  #   ..  #
#  @$ $#   #
#  #   ..  #
# $ #$ ##. #
#      #####
############
