############
#      #####
#  ##$ ##  #
#  # $  ...#
#  @$ $    #
#  # $  ...#
#  ##$ ##  #
#      #####
############
