#########
#####  ##
## $   ##
#  # #$##
#.@.   ##
## # #  #
##      #
##  #####
#########
