##########
#####   ##
#### .#  #
###   @  #
##  * #  #
#  $ #####
# * ######
#  #######
##########
