#######
#   ###
# .   #
## $  #
####$##
#  $ ##
# @   #
###. .#
#######
