########
###   ##
# $ # ##
# #  . #
#    # #
##$#.  #
##@  ###
########
