#######
#   ###
# #  ##
#. #$ #
#  @  #
#.##$##
#    ##
#######
