########
###  ###
### .  #
##@$$$ #
# . . ##
#   ####
#  #####
########
