########
###   ##
#     ##
#  #.###
##@$$$ #
##.#.# #
##     #
##  ####
########
