########
###   ##
# $ # ##
# #  . #
# .  # #
##$#.$ #
##@  ###
########
