########
##   ###
##$# ###
#   $@ #
# #  # #
# #. . #
#   ####
########
