###########
###.    ###
###.### ###
# $.# # $ #
# $.### $ #
#  ....   #
###.    ###
###.    ###
###. @  ###
###     ###
### $ $ ###
# $  $  $ #
# $ ### $ #
#   # #   #
### ### ###
###     ###
###########
