############
##        ##
# ...# ... #
# .$$## #.##
# .$ # $$.##
#  $  $ $ ##
#$$##.  $ ##
#    *$$$$##
# ## ..   ##
#.@######.##
############
