#############
#####   #####
### # $ # ###
#     ##    #
#  $ ... $  #
##$#.# #.#$##
#  $ ... $  #
#    ##     #
##  # $ #  ##
##### @ #####
#############
