############
##        ##
#  $ .$    #
# $ #.###. #
## # ...#. #
## # #$$#. #
## # # $ ###
## . . $   #
#   # #$$$ #
# $.       #
#  #########
# ##########
#@##########
############
