############
##        ##
#  $  $    #
# $ #.###. #
## # ...#. #
## # #$$#. #
## # # $ ###
## . .     #
#   # #$$$ #
# $.       #
#  #########
# ##########
#@##########
############
