#############
####     ####
##   $ #   ##
#   *...# ###
#  $ #.#    #
## $#.  $####
# $$....@ ###
#  $ $# $ ###
##       ####
#  ##########
#############
