############
##  ..  # ##
#  .##. # @#
# . .. .# ##
#  .##. # ##
#   ..    ##
# $ $ $ $ ##
# $ $ $ $ ##
# $ $ $ $ ##
#  ###### ##
# ##########
############
