#################
###           ###
##    $ $ $    ##
#    #######    #
#  ##   #   ##  #
# $ $ $ # $ $ $ #
## #.........# ##
## @#########  ##
###           ###
#################
