#############
#####   #####
#  $     $  #
# $ # # # $ #
#  # ... #  #
##  .   .  ##
#  # ... #  #
# $ # # # $ #
#  $     $  #
##### @ #####
#############
