#########
##  #####
# $  ####
#   $@$.#
#  #$#$ #
#   $  ##
# $###.##
#    #..#
#### $..#
##### ..#
#########
