###########
###     ###
###$# $  ##
### # #  ##
##    #$ ##
## #$ # ###
##$#... $@#
#   ...   #
#     #####
###########
