#########
###    ##
# $ $$ ##
#  $@$ .#
# # $# ##
# $ $ ..#
###  ...#
######..#
#########
