############
#        ###
# $$$$  $ ##
#  ..# ##  #
###..#  $$ #
###..# @#  #
###..* ##$ #
###..#  #  #
###### ### #
###### $ $ #
######     #
############
