#############
###        ##
### $#$#$#$##
###        ##
###$#$#.$$  #
###.# #.@## #
## .# #.$ $ #
##...... #  #
##.###..$#$ #
#  $        #
#  ###### $##
#########  ##
#############
