###########
###     ###
###$# $  ##
###   #  ##
##    #$ ##
## #$##  ##
##$#... $@#
##  ...#  #
#   # #####
#      ####
###########
