##########
#        #
# $$$$$ ##
# # # #$ #
# ...... #
# ..#.#. #
# $$$ $  #
#@       #
##########
