################
###  ###########
#............. #
# #.#########  #
# #.#   @  ## ##
#  # $ ###  # ##
## # $ $ $  # ##
##  $ $ $ $ $ ##
####   $ $ $# ##
#####$$ $ #   ##
##### ####### ##
####  ####### ##
####          ##
############  ##
################
