#########
##.######
#  ######
#   $@. #
# $#$#.$#
#   $   #
# ####$ #
# ..   .#
#########
