############
#          #
# # #.#$####
###  .  ## #
#  $#.#$   #
# #  .  $# #
#    .     #
# #$#.## # #
#    ..    #
# #$ #.#$# #
#     .    #
# #$ $. $# #
#    #.#   #
# #  $.  ###
###$#$.$## #
#@         #
############
