##################
######   #########
#####  #  ########
#####  $  $     ##
##### ### ##### ##
##### ### ##  # ##
####    $ ##$ # ##
###   $ #     # ##
### $##$#  #### ##
#    .....#.$   ##
# $ $.......  $ ##
# ##### # ########
#     $    $@#   #
# ##### # ####   #
#                #
##################
