################
#  #############
#              #
#  ########### #
#              #
#  ..######### #
# #..######### #
###..#         #
#    # #########
#  #   #########
##$@############
## $ ###########
##$  ###########
# $  ###########
# $$ ###########
#    ###########
################
