##########
##      ##
#    $@ ##
# $####$##
##  ### ##
##$  ## ##
##   ##  #
##$*..   #
## ...# ##
##$*..#$##
##      ##
##########
