##########
#        #
#   $  $ #
#  ###$###
## #     #
## #  $  #
## ## ####
##$## #  #
##  @..  #
##$  ..  #
##   ..  #
##########
