###################
#..               #
#..########### ## #
#..               #
#  ############ # #
#####  ######## # #
#####         # # #
##### ######  # # #
##### # $@$  ## # #
##### # $ $$$## # #
##### #       # # #
####  #########   #
####              #
################  #
################# #
################# #
###################
