##############
#.## ####.## #
#    ####    #
# #$ #### #$ #
# # ##### # ##
#     ##     #
#####.## #####
#####    #####
##### #$ #####
##### # ######
####  @   ####
#.## ####.## #
#    ####    #
# #$ #### #$ #
# # ##### # ##
#    ####    #
##############
