############
#  #########
#       ####
# ####  ####
# # ## #####
# ###. #####
# ## $ #####
#.. $  $@. #
#.#$$$#$#.$#
#.# $  $   #
#.    ###$ #
#### ..   .#
############
