##########
###    ###
# $ ##$###
# #  $ ###
# #  # # #
# #..#@$ #
# #.*#$  #
#  ..# # #
####     #
####   ###
##########
