###################
#                 #
# ############### #
#   #### .####### #
###  ##.. ..      #
### #### . #### # #
### #  ## ##  # # #
### #   # #   # # #
### #   # #   # # #
### #   # #   # # #
### #   # #   # # #
### #   # #   # # #
### #####$##### # #
###     $ $     # #
###@## $ $ $###   #
#####         #####
###################
