##########
##  ######
##  ######
##       #
###.#.#$##
### #@.  #
#  .$$*# #
# $$$  ..#
###   ####
##########
