###########
#  ####  ##
# .####. ##
# .####. ##
#  ....  ##
# $$$$$$  #
# $@   $  #
#### ### ##
# $    $ ##
# $$$$$$ ##
# #    # ##
#  ......##
#  .####.##
#   #### ##
###########
