############
#######....#
#######. ###
###### ...##
###### . ###
##     ....#
# $$$$  ####
# $   # ####
# $$$ #@####
# $     ####
# $$$$ #####
#       ####
############
