############
####  ######
####   @####
####  ######
###     ####
### *.#   ##
### *.     #
##  #*$#   #
#   *.  # ##
####$#    ##
#   $   # ##
###   #   ##
############
