################
##@       ######
##$ $ $ $ ######
## #######  ####
## $ $ $ $ ....#
## # # # # ....#
##         ....#
## # # # # # # #
## $ $ $ $ # # #
## ######### # #
#            # #
# ## #######   #
#      ####### #
################
