#######
#   ###
#  $ ##
# $# ##
#  #..#
# $@..#
##  $ #
####  #
#######
