################
#####  #########
#        $ $ $ #
# . . . #$ $ $ #
# . . . #@     #
################
