#########
## .  ###
## $ $ ##
#..$$$..#
##.$@$.##
#..$$$..#
## $ $ ##
###  . ##
#########
