############
###       ##
### #   #$##
##.@### # ##
#...##### ##
#...#     ##
#$$$#$$$# ##
#          #
#  ######  #
#         ##
############
