#############
#   #####   #
# $ #   $ $ #
# $   ###  ##
##$#..$ # $##
#  ##.. @  ##
#  ##...# ###
#  ###..# ###
#  # ##$# ###
#  #  #   ###
#  ####$#####
#       #####
######  #####
#############
