##########
###@  ####
## $#  ###
# $...  ##
# #.  #$##
# $.$.$ ##
# $.#.$  #
# #..*$$ #
#        #
##########
