##########
###@  ####
## $#  ###
# $.$.  ##
# #.$.#$##
# $...$ ##
# $.$.#  #
# #.$.$  #
#        #
##########
