#########
##  #####
# ..#####
# $.  ###
#  $#$@##
# $.$ $ #
##.. $  #
##$ . $ #
##  .. ##
#########
