############
###       ##
###.# ###$##
##.+#  $   #
#...#####$ #
#...  $    #
#..##$$$#$ #
#     $    #
# $##### $ #
#         ##
############
