#############
#####  ######
#####     ###
#####    ####
###### #  ###
###### #    #
#     $**** #
# $#$ $ ... #
#       #@. #
##########  #
#############
