############
#...########
#...      ##
#.. ####$ ##
#..##### ###
##       ###
##$ #$$# ###
##  $@ #   #
###  $ #$$ #
#### ###   #
###     $$ #
#######    #
############
