##############
#@##   . #####
# #  .     ###
# ### ##$$.###
# ###  . $   #
# $  .$###$ .#
# $.# $  #. ##
# $ # # .#  ##
### # ## ##.##
### $ $  $ $ #
###.  .   .  #
##############
