##########
####  ####
### $  ###
## $  $ ##
##  #   ##
## $ $$ ##
### $@ ###
####$ ####
#........#
##########
