###################
#  ############   #
# $             $ #
#.# # # # # # # ###
#.# # # # # # # #@#
#.# # # # # # # # #
#.# # # # # # # # #
#.# # # # # # # # #
#.# # # # # # # # #
#.# # # # # # # # #
#.# # # # # # # # #
#.# # # # # # # # #
### # # # # # # # #
#   # # # # # # # #
# #$#$#$#$#$#$#$# #
#                 #
###################
