############
######  ####
###@     ###
### # #.   #
##  # # ## #
##$## #.#  #
#     ##   #
# #  ....# #
# $ #$  ## #
# $$$ ###  #
##        ##
############
