###################
#.  ###############
##               ##
## ########### # ##
##             # ##
# ### ######## # ##
#                ##
# ### ######### # #
#     # #######   #
# ### ###       # #
#     ##  ##      #
# ### ## ### ### ##
# #      #       ##
#    ##     ###  ##
##$# ###### #######
##               @#
###################
