#########
##    ###
###.. ###
# $ .$###
# # .$@##
#   . $ #
##$$..  #
## ## $ #
##     ##
#########
