#########
#       #
#  #### #
# $.$ # #
# ......#
# #.### #
# $$#   #
# $@$ $ #
##$   # #
##  #####
#########
