###################
#..               #
#..############## #
#..               #
#  ############# ##
##                #
##$#############$ #
#                 #
# ##############$##
#                 #
################$ #
#                 #
# $############# ##
##              $ #
## ############## #
#@                #
###################
