#########
##     ##
# $ # $ #
# #   # #
# $   $ #
# ##.#  #
#  #.#  #
# ..... #
#  #.#  #
#  #.#  #
# $ $ $ #
# # @ # #
# $ # $ #
##     ##
#########
