###################
#@. . . . . . . . #
# # # # # # # #   #
# $$$$$$$$$$$$$$$ #
#  . . . . . . .  #
###################
