##########
##   #####
# $#  ####
#   # ####
# $ #    #
#  $ ### #
# $# ##  #
#  #... ##
# $@...###
##  $ ####
####  ####
##########
