###############
#########   ###
##    ## $ $ ##
##  #.##  $   #
#....... $ $$@#
##  #.##  $   #
##    ## $ $ ##
####  ###   ###
###############
