#################
######        ###
######  $ $     #
#######$###$ $$ #
####### # $   $ #
####### #  $  ###
####### $ $###  #
####### #@   ...#
####### $  ###..#
####### #  # #..#
####### #### #..#
# $ $ $ ######..#
#             ..#
##############..#
#################
