################
####  ##########
####   # ...####
####   # ...####
####$#$# ...   #
####  $      # #
###  # # # ##  #
#    # @    # ##
# #    #  $$  ##
# #$#$ ## #  ###
#  $   ## $ ####
### #####  #####
###       ######
################
