#########
#   #####
#  $.$ ##
##$#.#  #
##  +   #
##$#.#$ #
## ...  #
##$#.#$ #
#   $   #
#    #  #
#########
