###################
#                 #
# ####### ## # ## #
# #  .  # #  $  # #
# #  #  # #  #  # #
# # ... # # $$$ # #
# #  #    #  #  # #
# #.....  #$$$$$# #
#    #   @   #    #
# .......#$$$$$$$ #
# ######## # #  # #
#                 #
###################
