#########
#  ..####
# #..####
# #..   #
# $ $ $ #
# # #$  #
# $ # ###
##    ###
### $####
### @####
#########
