###############
######   ######
###### # ######
####   # ######
#### ### ######
###  #    #####
###       #####
###  ## #######
#.....#       #
###...# #   # #
# $...# #  #  #
# $ #.# # # $ #
#  $ ## ## $  #
##  $ # #@$  ##
###  $   $  ###
####  $$$  ####
#####     #####
###############
