###########
#######   #
### . . . #
# #$ $$$###
# .. .. ###
# $ ##  ###
# $. ##$ ##
## .    . #
## #$# $$ #
## $ ##   #
## #.# ####
##    @####
###########
