################
#   #   ...#.#.#
# $ $ $..  ... #
#  $ $@#.. #.# #
# $ $ $### #.# #
#  $ $     # # #
# $ $#$#$# # # #
# #  # # # # # #
#              #
######## ### # #
########       #
################
