#########
#.. #####
##.$#####
# . #####
#.. #####
#.$$$ $@#
#   $ $ #
#       #
#########
