###################
##@#      #       #
##$#.   #      # ##
#  ###     #     ##
#      #  #  ##   #
#     ## #      # #
# # # # #   ###   #
#   #    #      # #
# ### #   #    #  #
#       #  ###   ##
# ##  #      #  # #
#       #    #    #
# ## ###  #   #   #
#          #  ## ##
# ####### #      ##
#             #  ##
###################
