#########
#.. #####
##.$# ###
##.   ###
#..## ###
#.$$  $@#
# $ $ $ #
#       #
#########
