##########
#........#
##$$#$$# #
## $  $  #
#  $# $# #
# $@ $   #
# $  $   #
# $$#$$# #
#........#
##########
