###########
#         #
# $$#.#$$ #
# # . . # #
# $ ... $ #
# $ ... $ #
# $##.##$ #
#        @#
###########
