################
#####         ##
#   $ ####### ##
# #$#   ##  # ##
# #@# $     # ##
# #$# ##$## #  #
# # # #  #..## #
#     $  #.. # #
##  # ## #.. # #
##  # ## # .## #
#### $## ####  #
####          ##
################
