###########
#.... ....#
# $$$@$$$ #
# $ # # $ #
# $.# #.$ #
### # # ###
###     ###
##### #####
####   ####
####   ####
####   ####
###########
