#######
#.   .#
# $$$ #
# $@$ #
#.$$$.#
#.. ..#
#######
