###############
#             #
# #$#$  ...#  #
#      ##.... #
#      #####. #
##  ###@   #. #
#   # $$$$$#. #
#          #. #
#  # #$$ $ #. #
#  $ $      # #
#  # #  ##  # #
########## ## #
##########    #
###############
