#########
#    ...#
# # #...#
# $$$$$##
# $@ .$.#
# $$$$$.#
#    ...#
#########
