###############
#+..     ######
# $ $ $  ######
####### #######
#....      ####
# $ $ $ $  ####
######### #####
#.....       ##
# $ $ $ $ $  ##
########### ###
##########    #
##########    #
############  #
###############
