#############
###         #
### $###### #
###   $  @$ #
### $  #$#$ #
### ##      #
#     $ ### #
# $ $ # $   #
#####...  $ #
###.....$## #
###.....  $ #
#############
