###########
###   #   #
### $   $ #
# $   # ###
# $ $ # ###
#   $#. ###
#  $ #. ###
##  $# . ##
## $ # ...#
##    #...#
##$$$$ #..#
##    @#..#
###########
