#########
##  @  ##
# . $ $ #
# .$#$  #
# . ..  #
#  $#$  #
# .$.$. #
##     ##
#########
