###########
#####   ###
#  # $ $ ##
#    ...$ #
#  #.$*$. #
##   ...  #
##$##$ $ ##
##    @ ###
###########
