#########
### @ ###
## $ $ ##
# $...  #
# .$*$. #
#  ...$ #
## $ $ ##
###   ###
#########
