#########
#       #
# .$ $. #
# .$..$ #
# ...$. #
# $$$$$ #
# $...$ #
#      @#
#########
