#########
##  @  ##
# .$ $. #
# $# #  #
# .   . #
#  # #$ #
# .$ $. #
##     ##
#########
