#########
##  @  ##
# ...$$ #
#  $#$  #
#   ..  #
# $$#$  #
# .$. . #
##     ##
#########
