#########
### @ ###
##  $  ##
# $...  #
#  $*$  #
#  ...$ #
##  $  ##
###   ###
#########
