#########
#   @   #
# $$. $ #
#  .$.  #
# .$.$. #
#  .$.  #
# $ .$  #
#       #
#########
