#########
##  @  ##
# ...$  #
#  $#$$ #
# .   . #
#  $#$$ #
#  $... #
##     ##
#########
