#########
### @ ###
## $ $ ##
#  ...  #
#  $*$  #
#  ...  #
## $ $ ##
###   ###
#########
