#########
#       #
#  $.*  #
# *$.$$ #
# ..*.. #
# $$.$* #
#  *.$  #
#      @#
#########
