#########
### @ ###
## $$$ ##
#  ...  #
# .$*$. #
#  .*.  #
## $ $ ##
###   ###
#########
