#############
##      #  ##
#  #$  . $ ##
#. # #.  # ##
#    $ $$  ##
# $$$#  ## ##
##     ##. .#
#  ### ..   #
#.  @$ #  ###
##.##$  .####
####   # ####
######   ####
#############
