################
#       ########
# $ $ $ ########
#  #### ########
# $# $  ########
#   $ # ###.   #
# $$  #  ##. # #
#  ### @ ## .  #
# $###   #  #.##
#  #####   ## ##
######    ###.##
######   #### ##
###### . . . .##
######         #
################
