#############
#      ######
# #$.# #  ###
# #..# #$ ###
# #$.#.   ###
# $.$$.#$ ###
# #$.@$#  ###
# #.# .## ###
# # ##. #   #
##   #.$    #
###$   $  ###
###  ########
#############
