#######
###.###
#   # #
#.$ $.#
# #$# #
# $@$ #
# . . #
# #   #
##   ##
#######
