###################
############      #
############ #### #
############ #..# #
############ #..# #
############ #..# #
#####      # #..# #
##### $ $@$  #..# #
##### $###$  #..# #
###    # #   #..# #
### ##$###$#      #
#      $ $   #  # #
# # ## # ###### # #
#    $ $  $ $ $ # #
###             # #
################# #
###################
