#################
#   #           #
# $ $ $ ####### #
# $ ###      ## #
# $ # # ###     #
# $ # # # # # # #
# $ # #$### # # #
# # # # ....# # #
# # # # ....# # #
# # # # ....# # #
# # ###     # # #
# # ## $$$###   #
# #             #
# # ##########$ #
# #             #
# @##############
#################
