#########
#####  ##
##.##$ ##
##.##   #
##.## $ #
# ...$#.#
# $$$+..#
#    $$.#
# ##$$  #
#   $ ###
###   ###
#########
