#################################
#####################  ##.    ###
##### $                #####  ###
#####   ############## #   # ####
#########            # #   # ####
#  ################### #   # ####
#                      #   # ####
# ################## # #   # ####
#     .#         #.# # #   # ####
#   ############## # # #   # ####
# #                # # #   #   ##
#.# # ############ # # #   # #$##
### #                # ##  # # ##
### # # ############ #  #### # ##
### # # #.               $   # ##
### # # #################### #  #
### # #                         #
### # # ######################  #
### #                       #####
#   # # ##################  #####
#       ##################$ #####
## ###$ ##################  #####
##    @##########################
#################################
