##############
##   #########
## $ #  ######
## $ $  ######
## $ #  ######
## $ #   #####
## $ # .  ####
## $ # ..  ###
## $ ##...  ##
## $   #...  #
## $    #... #
## $$$   #...#
#  $@$    ####
#   #  #######
##############
