###############
#... ##########
#... ##########
#... ##########
#...   $ $ $ ##
#... # $ $ $ ##
#   ##$#    $ #
###    # ###  #
####  $#   #$ #
#####  ###    #
##### $#####$ #
#####  $@$ $  #
######        #
###############
