#############
# #  ########
# $    ######
# # **  .####
# #  *   .###
# # $**.  ###
# # $ *.  ###
# ###  .*  ##
#   # $ **  #
##   ##  ** #
###   #   $ #
####@   #####
#############
