##############################
#@############################
# ############################
# ############################
# ############################
# ############################
# ############################
# ########################   #
# #                          #
# #   ##################### ##
# #  $ ###.....##         # ##
# #   $ #####.. ##        # ##
# ###  $ ## #..  ##       # ##
# # ##  $ ####    ##      # ##
# #  ##  $ ####    ##     # ##
# #   ##  $ ####    #     # ##
# #    ##  $ ####   #######  #
# #     ##  $ ####           #
# #      ##    ###  ##########
# ##########   ###############
# $            ###############
#  ##########  ###############
##############################
