#######
###   #
#..$$ #
#.$$. #
#.$.+ #
#.$$$ #
##    #
#######
