##########
###.#.  ##
## *#.   #
#  *.#.# #
# #$ +$  #
#  $$$$# #
# #  # # #
#        #
##########
