#########
#.#######
#.#######
#....   #
#.###.# #
#     # #
# $$# # #
#   $   #
# $$@$  #
# $ $   #
#       #
#########
