########
##    ##
##.$#  #
#.$@$  #
##.*.###
## $ ###
##   ###
########
