############
####     ###
##  $$$$ $ #
#@$#       #
# $   $ $$ #
######. #  #
##### .... #
##### ..#.##
##### .##.##
##### ....##
#####  #$ ##
#### $ #   #
#### # $ $ #
####      ##
############
