############
#.*.  .#####
# #$ $ #####
# # $  #####
# #$ *#  ###
# $  . $  ##
#. . $#  *+#
## $   #####
###  $   ###
##### ..####
############
