##########
##   #####
##.#$.####
#.. $    #
#. $$$## #
##  *@## #
######## #
######## #
###*..## #
#. *$ ## #
## #..## #
# $$$$## #
#        #
##########
