#########
#.    ..#
#.$$$$###
#  $+$ ##
#  $.* ##
#  $ . ##
# $.## ##
###.   ##
#########
