###########
##       ##
## $.$ $ ##
# $#.#.#$##
#  .## .. #
# $#####$ #
#  ..##.  #
# $#.#.#$ #
## $@$.$  #
##       ##
###########
