###########
#         #
# $ $#$ $ #
# #*..  # #
# $.$$. # #
# #.$+$.# #
#   .$$.# #
#   #...# #
# $###### #
#         #
###########
