##########
####. ####
#  .$ ####
#.$.  ####
# $$$#####
#..$    ##
#######  #
####..## #
#..*..## #
##$ $ ## #
# $$$$## #
#  @     #
##########
