########
###   ##
### #  #
### #$ #
### .$ #
###$.$##
#  $.@ #
#  $.# #
#  $.  #
### .###
####.###
########
