#########
#.#     #
#.# $$$ #
#.#   $ #
#.. #$$##
# .    ##
# ...$###
#   $@$ #
#  #### #
# ##### #
#       #
#########
