#################
########   ######
#######  $  #####
#####  $#$$ $  ##
##### $$...  $@##
####   #..... $ #
#  $ # #....$   #
# $$   #....$ ###
#  #   #$###$ ###
## ####       ###
##        #######
##  #############
#################
