###########
#       ###
# ...##$ ##
# ...#  $ #
# ... $   #
# #$ $  ###
# # $##$ ##
#    ##@ ##
#  #$#  $ #
##        #
###########
