#########
#   #####
#  .....#
#  #. .##
# $@$# ##
# $$$  ##
##   $ ##
# $### ##
#      ##
#########
