##########
#  @     #
# $$$$$$ #
# $ $ $  #
# $ # $###
# # .  ###
# * *#  ##
#    .  ##
# # ##  ##
# .  ...##
# .  ...##
#######.##
##########
