###########
#  ####   #
#   .$. $ #
# $ ... $##
##$$.$*$ ##
##   $@. .#
##   ##...#
##$$###. .#
##    $ $##
##   #   ##
###########
