##############
#     #      #
# $ $## #### #
# $ $   #### #
# $#$##....# #
# $    ....# #
# $$###....  #
#   ## .... ##
# $ ## #### ##
# $ #  #  # ##
# $$# ## ## ##
# $ $ #  #  ##
# $ ###### ###
#  @        ##
##############
