##############
#..         ##
##.#$$$##$$  #
##.#   #     #
##.  #$#  $  #
##.... $@##$ #
## ...$#    ##
##        # ##
##  ###  # $##
## #  ## $  ##
##          ##
##############
