##########
#        #
# #$$$## #
# #  @#  #
# #$#$#.##
#   .  .##
# # ## .##
# $  . .##
# #$## .##
# . $ $ ##
# .     ##
####### ##
##########
