########
###   ##
###$#  #
###@#  #
###$*  #
### .$##
# $ .  #
#  $.# #
#  $.  #
### .###
####.###
########
