########
###   ##
###$#  #
### #  #
### .  #
###$. ##
#  $.$ #
#  $*# #
#   .$@#
### .###
####.###
########
