##########
#  #######
#   $    #
# $   #$ #
##  #$# ##
##      ##
##...#$$##
#  ##   ##
# ....$ ##
#####.$ ##
#####. $##
#######@##
##########
