##########
#        #
# #$$ ## #
# #  $#  #
# # #@# ##
#   .$  ##
# * *#  ##
#    .  ##
# # ##  ##
# .     ##
# .     ##
####### ##
##########
