###############
#########    ##
#             #
# # # # # # # #
# #$ $ $ $ $#@#
# # .  .  . ###
# # . .#. . ###
# #$ . . . $###
# # . # # . ###
# #$ $ $ $ $###
# # # # # # ###
#           ###
###############
