###################
#                 #
# ############### #
# #         #  ## #
# # $ $ $ $ #  #  #
#   ############  #
#  $      #.....  #
#  #$ $    .....  #
# $  $### #.....# #
# #     $ ### ### #
# #### ## ###$# # #
# ####   $ ##@# # #
#      $ # ##$# # #
# #####  $    # # #
# ########### ### #
#                 #
###################
