#############
#          ##
# #$$$##$$$ #
# #   #     #
# # #$#   ###
#   . $@#####
# * *#  #####
#    .  #####
# # ##  #####
# ....   ####
# ..     ####
#############
