###################
#                 #
#    #######      #
#             #   #
#....#######    # #
#....######## #   #
###########     # #
###########  #    #
###########     # #
###########   #   #
#############     #
############## #  #
#                 #
# $ $ $ $ $ $ $ $ #
# ############# # #
#@                #
###################
