##########
###.. ..##
###  $  ##
## #$ #$##
## $  $@##
#.. $ $ ##
## # $#$ #
## #..$  #
##  $. $ #
##..  .  #
##########
