############
######### ##
######    ##
###  $ $. ##
### #..#. ##
### $.# $ ##
### #.$.$ ##
### $.#.#  #
# $ #.#. $ #
#   $.#.$$ #
##  @$     #
########  ##
############
