###########
######    #
##...#$$$ #
##.   $   #
##.  #$  ##
###@ #   ##
# .. #$$ ##
# .   $  ##
# .#  $  ##
#..##$$ ###
####    ###
####  #####
###########
