##############
###     ######
###$ $$$######
#  $         #
# #$$$###$$$ #
#     ##.    #
# #$$$## .####
# # $ ....####
# #@ ###. ####
# ####....####
# ####...$####
#      #..####
##############
