#############
#        ####
#  ##### ####
# $      ####
# $$ # ######
# #  # ######
# $$ # ######
# #  # ######
# $$ # ######
# #  # ######
# $$ # #    #
###@   .....#
########....#
#############
