############
######   ###
####   #   #
#  $ $ $ # #
# $ ####$# #
# $ $ $  # #
#          #
####.#.#.  #
##  #...#$##
##  ....#@##
##  .#. .$##
## $ $ $  ##
##      ####
############
