#########
###   ###
###$#.  #
##....$ #
###... ##
### ## ##
### $  ##
#  $$$ ##
# #@$  ##
# ####$##
#      ##
#########
