###################
######  ....####  #
######      ....  #
######  ########  #
#########      # ##
################ ##
#########      # ##
#########$ $ $ # ##
######### $@$  # ##
##  #### $ $ $## ##
##            ## ##
## ############# ##
## #           # ##
#  ############# ##
#                ##
###############  ##
###################
