###########
########.##
#####  ..##
### $  #.##
##  ## #.##
## $#  $.##
##  #$# .##
## $# #...#
##  # # $ #
#  $# #$$ #
#  @$     #
#######  ##
###########
