#########
#  #  ###
# $$$ ###
# $@$   #
# $$$ # #
#     # #
##...## #
##...#  #
###.## ##
###.   ##
#########
