###########
###     ###
###  #  ###
#  $   $  #
# # $#$ # #
# #  @  # #
# # $#$ # #
#  $ $ $  #
###  #  ###
### ... ###
### ... ###
####...####
###########
