###########
#######...#
#..... ...#
###### ..##
###    .###
### $    ##
##  $  $ ##
#  $$$$ ###
# $   $ ###
# $ ##$ ###
# $   $ ###
#### #$####
####  @####
###########
