###########
###.. ..###
##..   ..##
## #   # ##
#    #    #
# #$ $ $# #
# # $#$ # #
# # $ $ # #
# # $@$ # #
# # $ $ # #
# # $#$ # #
# #$ $ $# #
#    #    #
## #   # ##
##..   ..##
###.. ..###
###########
