###########
#######...#
#..... ...#
###### . .#
###   #. ##
### $  $###
##  $ $  ##
#  $$$  ###
# $  @$ ###
# $$##$ ###
#    $  ###
#### #$####
####   ####
###########
