##########
##       #
##$#..## #
## .$  . #
##$.$ $. #
##  # ## #
##$.$ ## #
##  # ## #
##$.$ ## #
##  # ## #
##$ ..## #
## #@. $ #
# $ . ####
#     ####
##########
