##############
#######.#.#.##
####### . . ##
####   . . .##
#     #### ###
#     ##    ##
## ####  ##  #
##    #$ $ $ #
## ## # $@$  #
## #  #$ $ $##
## #        ##
## # #########
#  #  ########
#     ########
#  ###########
##############
