##############
########  ####
##### $  $ ###
#####   $    #
###   #$ $ $ #
### #   $@$ ##
###   #$ $  ##
### #   $ $ ##
###   #$ $  ##
##  # . $  ###
#.........####
#.....########
##############
