################
######         #
######   $$$$$ #
#....#   $   $ #
#....# $$$$$ $ #
#....# $@  $ $ #
#....# ##### ###
#             ##
###    #########
################
