###########
#     #####
# $$#$#####
#  $  #####
## $# $ $ #
## $ $ ...#
# $...$.#.#
# $.#.$...#
# $...#   #
#     #$$##
####### @##
###########
