##########
####. .###
####. .###
##  ...###
##  ...  #
### # #$ #
# @$$$  ##
# $  $  ##
# $ #$  ##
# $  $ ###
#### # ###
####   ###
##########
