##########
##.##.####
##.##.####
##.  .####
##....   #
### # #$ #
# @$$$  ##
# $  $  ##
# $ #$  ##
# $  $ ###
#### # ###
####   ###
##########
