#########
###+  ###
###*# $ #
## *    #
## * # ##
#  *   ##
#   #####
#########
