########
##   ###
# ...* #
# #@$# #
# $    #
### #$##
###   ##
########
