#######
##   ##
##.#$##
##    #
##.#$ #
##   ##
##.#$##
##   ##
# .#$##
# @  ##
#  ####
#######
