##########
###  #####
#    #####
#  #  ####
## . . .##
##$##.#$##
# $  @ $ #
#   ##   #
##########
