#########
##  #  ##
##$ + $##
## .#. ##
##$.#.$##
# $ . $ #
#   #   #
#########
