#########
###   ###
###*# $ #
# $ @ # #
# # ..  #
# . #$###
##$.  ###
##  #####
#########
