#########
######  #
##### . #
#### $  #
# $ $.@##
#  .  ###
#########
