##########
#   .#####
# . @#####
# # ######
# # $ ####
# *.   ###
#### $$ ##
#####    #
######   #
##########
