########
###   ##
###*# ##
#    * #
# #  # #
# * +  #
##  #$##
###   ##
########
