########
#   *  #
# +*** #
##  $  #
###   ##
####  ##
########
