########
##   ###
## # ###
## *  ##
# $*$  #
#  * # #
## .  +#
########
