#######
##   ##
## #$##
## @  #
# .#$ #
# .  ##
# .#$##
##   ##
#######
