########
###  ###
#   .  #
#  $ $ #
##.#+#.#
## $ $ #
####  ##
########
