#########
#####  ##
# $   $##
#  .#. ##
## ### ##
## .#.  #
##$ @ $ #
##  #####
#########
