#############
#           #
# #.$$$$$.# #
#  $.#.#.$  #
# $...@...$ #
#  $.#.#.$  #
# #.$$$$$.# #
#           #
#############
