#########
###..   #
#  ...# #
# ##. $ #
# $ $$$ #
### #@$ #
###   ###
#########
