#########
#####   #
##### $ #
#   $...#
#  $  #.#
###@$ #.#
### #$###
###     #
#########
