#########
###  .  #
### $#$ #
#   .$. #
# # $$$ #
#   $@$ #
###.$#$.#
###.....#
#########
