############
#    #######
# $ # .   ##
# $$  ..# ##
# $@# . # ##
# #$   .   #
#  $$$#... #
#         ##
############
