###############
#     ##  ... #
# $$$ # . *.  #
#   $ # #.#.# #
# $ $ #  ***$ #
# $$$ ###.*+# #
#         . ###
####### # # ###
#######     ###
###############
