#########
### ... #
#  ..*  #
# ##. $ #
# $@$#$ #
### $ $ #
###   ###
#########
