###############
#######       #
###     $$$   #
#   $$ $   $$ #
# # # $ ### $ #
# # #    ## $ #
# # ##    #@$ #
# # ###   ##  #
#   ..###  ####
##  ..........#
###############
