###########
##   ######
#    #  ###
# $$$   ###
# $@$  ####
# $$$  ...#
## # #.####
#    ....##
###########
