#############
###         #
#   #$#$#$#.#
# $$$ $ # ..#
# $     $ ..#
# #.###*# ..#
# #...... . #
# #$ $$$$ $ #
#   # @ #####
#############
