#############
#########  ##
###   $  . ##
###  $ $.#.##
##  $ $.#. ##
#  $ $.#.  ##
# $@$.#.    #
## $# .     #
##    #######
#############
