##############
#            #
# ####  ## # #
# #     #..# #
# $$$$$  ..# #
#  @$ ###..# #
# $$#    ..# #
#            #
##############
