###########
#         #
# ##$ $ # #
#   $$$$$ #
# $ #     #
# $$#.....#
##$ #.###.#
#@$  .....#
###########
