#########
###..#..#
###..$..#
###$.$.$#
#   .#. #
# ##$$$##
#   $@$ #
### $$$ #
###     #
#########
