#############
######      #
####   #### #
#     ##### #
# #$$   ... #
# #@ $ #... #
# #$# $ ... #
#   $ $ $ $ #
# # #########
#   #########
#############
