#########
###@.   #
#  ...# #
# ##. $ #
#   $$$ #
###   $ #
###   ###
#########
