###############
##########  ###
#             #
# # ######..# #
# #      #..  #
# # ## # #..###
# #   $# ######
# # #  #    ###
# # @ $##$$ ###
# # #  $ $  ###
#           ###
###############
