##############
# $         .#
# $ $ $$###..#
# $ $ $ .....#
# $ $ $ .....#
# $ $ $$###..#
#@$         .#
##############
