###########
###   #  .#
#   $   #.#
#  $#$  #.#
# $@  ###.#
# $$$# . .#
##     $# #
#####   ..#
###########
