###########
###      .#
##  $  ##.#
#  $#$ ##.#
# $@  #.#.#
# $$$# .$.#
##     $# #
#####   ..#
###########
