###########
###   #  .#
#   $   #.#
#  $#$  #.#
# $@  #.#.#
# $$$# .$.#
##     $# #
#####   ..#
###########
