###########
##  #######
#.      ###
#. ###    #
#  .#  #  #
# ..#  $  #
#..###$#$ #
#.. $  #  #
#.#$#$ #$ #
##  @$ #  #
## $## $  #
#         #
###########
