##########
###  #####
###     ##
#   ##$  #
# #....# #
# ..$$$$ #
##.$  @# #
#  $#### #
###      #
##########
