###############
##  ###########
##........... #
##.#########  #
##.#       # ##
##.# $###$   ##
####  $ #  # ##
##   $  #$ # ##
##  $# $#  # ##
# $$ #  #$$# ##
#  @ #  #  # ##
####### $  # ##
### $ $  #   ##
###         ###
###############
