########
#..  .##
# ##$$.#
# #  $ #
# #$@$ #
# $    #
#  $## #
#.   ..#
########
