##############
#..    #######
#.# $  #######
# ###  #######
#  $@$  $ ####
# $###  $ ####
#.$        ###
#.. #####$ ###
###### $ $ ###
######.$ $ ..#
######..   .##
##############
