#################
###      ########
##  $ $  $    ###
## ## #  #$##.###
##$##$#$ #  #.###
##  $ #  ## #...#
## $  # $ $ ....#
# $  $@##   ....#
#    #    #######
#################
