###########
#   .*. ###
# #.###.###
# .  $  .##
# .  $  .##
###  $  .##
##### $.###
### # .$@ #
#   #.# $ #
# $ #.# $ #
# $  .  $ #
#  $ # $  #
### $*$ ###
###     ###
###########
