#############
#     #####.#
# #$$$ ...#.#
# $@$  ...#.#
#  $$$#...#.#
### $   #...#
### $$$$$$$ #
###         #
#############
