##########
#   .*. ##
# #.# #.##
#  . $ .##
# #  $ .##
#### $.###
#####.$ ##
#### . $@#
## $ . $ #
## $ # $ #
##  $*$  #
##       #
##########
