##########
#.########
#.   #####
#.$   ####
#. #$   ##
#. #@#   #
#. #$##$ #
##$   $  #
##       #
##########
