##################
#####....#########
####.....   ###  #
###..... $  ###$ #
########.#$####  #
#              $ #
# #$$$$###$##$$  #
# #            $ #
# #@##$#$###$##  #
#             ####
##################
