###########
# ....... #
# # ####  #
# #      @#
# ## $ $  #
#  $ # ####
####$ $  ##
#### $ $ ##
####     ##
###########
