##########
#        #
# .*.$$$ #
#  ... $ #
#@.#.$$# #
# $  #   #
####     #
##########
