########
#...#  #
# .$$$ #
# .@$  #
##.$$  #
###  ###
###  ###
########
