###########
####   ####
#         #
# # $#$ # #
#  #...#  #
# $ $.$ $ #
# #..@..# #
# $ $.$ $ #
#  #...#  #
# # $#$ # #
#         #
###########
