###############
#            ##
# $ $ $ $ $  ##
###$#$#$#$#$ ##
# $ $ $ $ $  ##
#@           ##
######  #######
######   ##. ##
###... # ##. ##
#####    ##.  #
##...   #  ...#
###   # ##  #.#
###         #.#
##########  #.#
###############
