#########
#... $  #
#.$. $  #
#.. $@# #
# $$*$# #
#*$ .   #
#.  $$# #
# $   ..#
#########
