################
#.  ###  #  #  #
##       # $$$ #
##. ###    $@$ #
##. # #  # $$$ #
##  #### #   $ #
#. . .  .# $$$ #
##.    ..#     #
####..##########
################
