###############
#### ...   ####
####$..* $ ####
####.###$# ####
# $ $ $ * $   #
#@  $   .    .#
###############
