################
##....######.###
#   $ .####....#
# $ $       $$.#
#####$ $$ $.$..#
#####  # .######
##### $# #######
#####  #$#######
### $ ## #######
###  $ $ #######
###@     #######
################
