##########
##.      #
#..$ $## #
#..$$  $ #
#..#@$$# #
######   #
##########
