########
###.# .#
#  $@$ #
#   $ .#
########
