###############
#   ....      #
# $ **.* $  $ #
####.#*#$# $###
# $ $ $ * $ ###
#@    ...   ###
###############
