################
#...........   #
#######.#### # #
#     #.       #
#     #.     ###
## ## #.    ####
##        $ ####
##   $ $ ###  ##
## ###### $   ##
## $ $ $ $ $$ ##
## $ $ $ $ $@###
#           ####
################
