########
#...#  #
#.**$$ #
# .@$  #
##.$$$ #
###    #
###  ###
########
