########
#     .#
# $#$ $#
#. $ @ #
##$$.$.#
#  $#. #
# .  ..#
########
