########
#...#. #
#  $@$ #
# $$$  #
###  .##
###   ##
########
