##########
#        #
# $$#### #
# #    $ #
# $ $#####
# #  #####
# # $#####
# $   ####
# #   $@##
# $$$*####
#.....####
#.##.#####
#.  ...###
##########
