###########
#####.#####
#   . .   #
#  . . .  #
##. . . .##
###     ###
#####$#####
##  $ $  ##
## $ $ $ ##
# $ $@$ $ #
#         #
###########
