##################
####..  .........#
#  .... # ########
#  #### #  #######
# $  $ $ $ #######
#  $## # # #######
#  $ #   $ #######
#      $ # #######
#####  $$$ #######
#   $      #######
# #$@$ $ #########
#    #############
##################
