###########
#####.#####
#.........#
#. .#.#. .#
## $ $ $ ##
##  $ $  ##
###  $  ###
##  $ $  ##
## $ $ $ ##
# $ $@$ $ #
#         #
###########
