#########
###   ###
#..@$$  #
##. $ # #
###     #
#########
