############
#########  #
#########  #
##   ####..#
#  #$#  ...#
#    $  #..#
#.# # $    #
#.  #  $ $##
#.  #   $@##
###$#$#$ $##
#         ##
############
