#################
#######   #######
####### $ #######
#######   #######
######## ########
######## ########
######## ########
#   ##  .  ##   #
# $    .@.    $ #
#   ##  .  ##   #
######## ########
######## ########
######## ########
#######   #######
####### $ #######
#######   #######
#################
