#################
#######   #######
####### $ #######
#######   #######
######## ########
#####  # #  #####
##### $$.$$ #####
#   #  ...  #   #
# $   ..@..   $ #
#   #  ...  #   #
##### $$.$$ #####
#####  # #  #####
######## ########
#######   #######
####### $ #######
#######   #######
#################
