#############
#           #
#   ##$##   #
# ##.....## #
#     $     #
# $#$$#$$#$ #
#  #..@..#  #
# $#$$#$$#$ #
#  #.....#  #
# #### #### #
#           #
#############
