###############
#             #
# #$# $#$ #$# #
#    #   #    #
# # $.. ..$ # #
#   . $*$ .   #
# #.###@###.# #
#   . $ $ .   #
# #  .   .  # #
# $ $ .$. $ $ #
# #####.##### #
#             #
###############
