#############
##     #   ##
#  #       ##
# # $# #   ##
# # $  #    #
#   $# #....#
# # $  #...##
# # $  #..###
#@$$$$$#.####
#      ######
#############
