#######################
########     ##########
####     ##$ ##########
####$$$$$    ##########
#         ..###########
# ## #####.############
#     ####.############
##########.############
#####   .#.############
#####   .#          ###
#####  #.  ########$###
#####  #.   $ $ $ $ $ #
#####   .. #          #
#####  ############  @#
#######################
