###########
#      ####
# #$##  ###
#  $   $###
#  $$# $@ #
# ## # $$ #
# $  #    #
# $  # ####
# $$ # $ .#
#    # $ .#
###### $$.#
#...     .#
#.........#
###########
