#########
#  .#####
# $ .####
#  $ .###
## .$@$ #
##### # #
#####   #
#########
