##############
####.....   ##
#.....      ##
# ## ##### ###
#          $ #
#####$ $ # # #
#####    # $ #
#####$ $ # $@#
#####  # #  ##
#####$$# $   #
#####     ####
##############
