####################
#@                 #
##$$$$$$$$$$$$$$$$##
##. #    # # # # .##
## .. ## # #   .. ##
#####..  #   ..#####
#######..  ..#######
#######  ..#########
####################
