###############
####  #.##.####
###  $#...    #
# # $ #.## ## #
#  $  #...  # #
# $ $ #.# . # #
#    $  #$### #
####  $   $   #
####@$  #$### #
#######       #
###############
