############
#          #
#  ####### #
# * $  $ # #
# *  ..  # #
# *  ..  # #
# * $  $ # #
#  ####### #
#@         #
############
