###########
#####   ###
# *   $ * #
# $ # ##* #
# #.#. #  #
#   . @   #
# *.#.#$* #
# * $ $ * #
#####   ###
###########
