##############
#####.....$ ##
#####.###$  ##
#####...$.# ##
#####.#.... ##
# $ $ $ ##$ ##
#  $ $@$   $ #
# $ $ $ ##$  #
#   #       ##
##############
