###########
####    ###
# .... .  #
# .$.$.$$ #
# $###$ $ #
# . .#@$$ #
#  $.$$#. #
# $  . .$ #
####    ###
###########
