#############
####    #####
#### $$ #####
####    #####
###### ######
###### ######
######.##   #
#   ##.## $ #
# $ ..@.. $ #
# $ ##.##   #
#   ##.######
### ## ######
###      ####
####  $$ ####
#####    ####
#############
