##########
#####..###
#####..###
###  ..  #
###$$  # #
###  ## @#
###$ # $ #
#    # $ #
# ##   $##
#       ##
##########
