##########
### ...###
##  #..$ #
# $ #..$ #
# $ #  # #
# $.$$$# #
#  .# @# #
##$.#$## #
##       #
##########
