###############
#####     #####
#####     #####
##   $ $ $   ##
##  $ $ $ $  ##
##   $ $ $   ##
## ####@#### ##
## # . . . # ##
## #. .#. .# ##
## # . . . # ##
## #       # ##
#  #### ####  #
#             #
######   ######
###############
