###############
######   ######
######$ $######
#             #
#  $$#   #$$  #
#......@......#
## $$$## $$$ ##
##    ##  #  ##
###############
