############
#  ..      #
# $$.##### #
#  $.##... #
## $.##. . #
## $.##. # #
## $....   #
## $$$$ $ ##
## #  $@$ ##
####  $$$###
####     ###
############
