##########
#...   . #
#  ##    #
# #   # ##
# # $ $$##
#  #*  $ #
# $+ $ . #
#  #*  $ #
# # $ $$##
# #   # ##
#  ##    #
#...   . #
##########
