#########
#       #
# $$ $# #
#   # . #
# $#..  #
# ..$.$ #
#     @ #
#########
