##################
######@ . .   ####
###### ## # # ####
####  .## # # ####
#### # ##$#$# ####
#### # ## # # ####
#### # ## # # ####
#### #  .        #
#  $ #    ###  . #
# $$$####    ... #
#     .    $ $ $ #
#######    #######
##################
