##########
#        #
#  .  .$ #
#  .. *$ #
#  .$*+$ #
# $. $*$ #
#        #
##########
