##########
### .  ###
##  #$$  #
#   #    #
# $ #$$# #
#  . $ #.#
# $.#@ #.#
##$.#$*..#
##    *.*#
##########
