##################
###### ##   ######
#####        #####
####  $###.#######
###  $  @#.#   ###
##  $ ## #.# $  ##
#  $     #.# #$  #
##  $ ## #.# # $ #
###  $   #.#  $  #
####  $  #.# $   #
#####  $.....  ###
######  ##.#######
##################
