###################
###  ########     #
###           $ $ #
### ### ########$ #
##   ##   ######  #
##   ##        #$ #
## #####$####  #  #
## # #... # # ##$ #
## ###...@# # ##  #
#   ##... # # ##$ #
#   ####### # ##  #
### #       # ##$ #
### #       # ##  #
### ######### ##$ #
##            ##  #
##   #######  #####
###################
