##########
#.     . #
#  .*$.. #
# #   # ##
# # $ $$##
#  #*  $ #
# $+ $ . #
#  #*  $ #
# # $ $$##
# #   # ##
#  .*$.. #
#.     . #
##########
