##########
### +..###
## $#**  #
# $ #..  #
# $ #  # #
# $.$$ # #
#  .#  # #
##$.#$## #
##       #
##########
