###########
#..   #####
##.$$$#####
#  $  #####
# $$$ #####
# $    $  #
# $ $.### #
#.##$.    #
#.#@ .#####
#.$ $.#####
#.# $.#####
#...$.#####
###########
