###############
##   ###@ #####
##   ###  #####
# $$$#...     #
# $  #... ##  #
# $  #...     #
# $  ######  ##
# $$$###### ###
#           ###
###  #####  ###
####       ####
###############
