##########
#####  ###
##.    $ #
#..   $$ #
#..$###  #
#.. # $$ #
#.. #@   #
##$$ #$# #
##       #
##########
