########
#  ##  #
# $..$ #
# $.*$ #
# ###  #
#  ..$ #
# $..$ #
#  ## @#
########
