##########
##### @###
##. $$$  #
#.*      #
#.*$###  #
#.. #    #
#.* #    #
##$$ # # #
##       #
##########
