###############
######   ######
######   ######
#             #
# $$$# $ #    #
#.*..*. *.**.*#
##    ## $ $ ##
##    ##@ #  ##
###############
