#############
####     ####
### $ $#  ###
##   ...# ###
#    #*#    #
##  #.$ $####
#   .*+*  ###
# $  $#   ###
###      ####
#############
