#########
#       #
# ..$.. #
#  * .$ #
# .$$ . #
# $+*.  #
# $$*$$ #
#       #
#########
