################
#########  #####
###     #..#####
### .     .#####
### . ###  #####
#   ...    #####
# $$# ...  #####
# $  #### ######
# $       ######
#### ###  $   @#
## $ $ $$$$   ##
##           ###
################
