#############
#   ...     #
# ##.$ $$$$##
# # .  $ # ##
#.$  #      #
#. # #$.$## #
#.....      #
# $ ... @#$ #
# $$$## ##  #
#      $  $ #
########    #
#############
