################
############.###
######   ##.  ##
#####   $ ##..##
####  $ #  # ..#
#### $   $   ..#
#######$$$# #. #
# @  ##  $ ... #
#   #### $$ # .#
###           .#
# $ $.##. ######
# $$$$##########
#     ##########
##   ###########
##  ############
################
