#########
###.#.###
## $.$ ##
##  .@ ##
#  $.$  #
# # . # #
# #$.$# #
#  $.$  #
###. .###
####$ ###
####  ###
####$ ###
###   ###
#########
