###########
######  ###
###  $  $@#
###.#$#.$ #
##  .$ .$ #
##   $.$$$#
# ... .$  #
##  . #$..#
###    $. #
###########
