##############
#####   ######
####.   .    #
##@$.....##$##
####.#...   ##
### $$..#$$ ##
##  $  .#    #
##  $#    $$ #
#   $  #     #
#   $  .#$$ ##
### $# #    ##
###  #   #####
##############
