################
#####         ##
##### $$$$$$$$##
#         # # ##
# ####### # # ##
#  ###### # # ##
#       . . . .#
#       ########
##### # . . . .#
##### #     ##@#
##### ####  ####
####        ####
####   ###  ####
################
