#############
#####   #####
##    $    ##
## ###$### ##
## # @$  # ##
#  #  $  #  #
#...*.*.*...#
#  #  $  #  #
## #  $  # ##
## ###$### ##
##    $    ##
#####   #####
#############
