##################
########       ###
######## #$$##  ##
###           $ ##
### ..... #####  #
### .....$       #
### .....#  $ # ##
###    ###$#### ##
###### ##@ #  # ##
#    # ##  #  # ##
# $$$# ## $#  # ##
#    #$    #  # ##
# $$    ####### ##
#   ##       $ $ #
############     #
##################
