############
##  #  #...#
##  $  #...#
## $#$  #  #
##  #    $ #
##  #$$  $$#
#  #  #    #
#  $  #$#$ #
##   ## #  #
### ...@#$ #
### ...##  #
############
