###########
####...####
####...####
#   ...   #
# ## . ## #
# ###@### #
#   $$$   #
##$     $##
## $###$ ##
##  $ $  ##
##   $   ##
###  #  ###
###########
