###########
#         #
# ###$### #
#   $@$   #
## $ $ $ ##
##  $$$  ##
### ... ###
### ### ###
##  ...  ##
##  ...  ##
###########
