###########
####   ####
#### $ ####
#         #
# ###$### #
#   $@$   #
#  $ $ $  #
##$ *** $##
##  ...  ##
### ### ###
##  ...  ##
##  ...  ##
###########
