###################
#############   ###
#             # ###
#  ########$$    ##
## # ####        ##
## # #  $$ ##### ##
## ###        ## ##
## # $$ ###$$ ## ##
##      ###   ## ##
####### ##@$  ## ##
####### ##$    # ##
#######  $  ## # ##
####### $   ## # ##
#######  ####    ##
#######    .......#
#############.....#
###################
