#############
####.########
# $  ..     #
# $$ .... # #
#  ##.### $ #
# $# . # $@ #
#  . $ $..$ #
# $#.   $.$ #
#  #. $#$ ###
# $###    ###
#  ##########
#############
