##########
####  ####
##  $.$ ##
##$ ..  ##
##  . #  #
#  .#@#  #
#  .$ $ ##
##   $# ##
####    ##
##########
