###########
####   ####
#  #$ $#  #
#  . . .  #
#  #$ $#  #
#  . . .  #
#  $$#$$  #
#  . . .  #
#  #$ $#  #
#  . . .  #
#  #$ $#  #
#### @ ####
###########
