###########
#         #
# ###$### #
#   $@$   #
##   $   ##
### $$$ ###
###  .  ###
### ### ###
##  ...  ##
##  ...  ##
###########
