#############
#########   #
#   ###     #
# * * # * +##
##     $* ###
##  *## * ###
###  ##  ####
#############
