#########
###  ####
##@ $ ###
## .* ###
# $$*.* #
# #.. # #
#   $   #
###  ####
#########
