#########
##    ###
## * .###
# *$*  ##
#@ * *  #
##* *   #
##   ####
#########
