#########
##   #  #
##.     #
# ***** #
#   * * #
## #$  ##
##  @####
#########
