##########
###  #####
###    @##
###** ** #
##  **.  #
# $  # ###
#      ###
##########
