#########
####  ###
## * * ##
#  * * ##
#  * *  #
#  $ * @#
###. ####
###  ####
#########
