#########
###  ####
##  .  ##
# $.$.$##
# .$.$. #
##$ #.$ #
##  @  ##
#########
