###########
#####  ####
####   ####
## * * *  #
#  * * $  #
#  * # * ##
## . ##@ ##
##  #######
###########
