##############
###  #########
###     ######
##   #     $@#
#  # . #$$$  #
# ## .##    ##
# #  ..## $ ##
# #  ...##$ ##
#   # #  $  ##
###        ###
##############
