###################
#                ##
# ############## ##
#                ##
## ############# ##
## ####          ##
##      ######## ##
## ###$######### ##
#  # #         + ##
# ## ### ####### ##
# #    # #     # ##
# ###### #     # ##
#        #     # ##
#  ##### #######  #
#                 #
#  ################
###################
