#######
# ..###
#  .###
#  .. #
## ## #
# $$  #
# @$  #
#  $$ #
####  #
#######
