#################################
#                ################
# ######## ##### ################
#          #   # ################
## ####### #   #                #
## ####    #   # #############  #
##      ## #   #   #         #  #
## ###$### #   # # ###########  #
#  # #   # #   # #              #
# ## ### # #   #  ######### ##  #
# #    # # # ###  #         ### #
# ##   # # # #+# ## #######   # #
#  #   # # ### # ## #     #   # #
#  ##### #  ## #  # ########  # #
#           ##    #           # #
#  ########### ####  ####### ## #
## #         #  # ##            #
## ############ #### ######## # #
## #                            #
## #  ####################### # #
## #                            #
#  ## ########################  #
#                               #
#  ###########################  #
#################################
