###################
###############  ##
# $        $     ##
#  ######$ ##### ##
## ##  #   # @ # ##
## # $ # ###$$ # ##
## # $         # ##
##    $######### ##
## #$   #   #  # ##
## #    $   #### ##
##$### $  $ #    ##
## # # # $### ##  #
## # #  $         #
## ### $###########
#      ........####
#  ### ........####
###################
