#############
###  ########
###         #
# $ $ ##  $ #
# $#...# #$ #
# @#...# #  #
# $#...# #$ #
#    ..# #  #
##$ #..  #  #
##  ###$$####
##$ $ $  ####
##      #####
#############
