#############
######@     #
#######$### #
##.#   $ #. #
##    $$ #  #
#  ### #  $ #
# ###  $  $ #
# ... $ #####
##...   #####
#############
