##########
##      ##
#  $ ##$ #
# $#..#  #
#  #..#$ #
# $#..#  #
#  $..#$ #
## #..   #
##$###$  #
## $ @  ##
##     ###
##########
