###################
#############     #
############# # ###
#####   .#### # $ #
####    .#### # $ #
####...#.   # # $ #
####   .#...# # $ #
####   .      # $ #
###### . @    # $ #
###### # # #  # $ #
##     # # #    $ #
#  ###     # #### #
# #    ###      # #
#    #      ##    #
##$#$ ##### ##$#$##
#                 #
###################
