#############
##   ########
#   $     ###
# $#  $ $ @##
#   ####$$$##
# $$#  #   ##
# $      $ ##
###### # # ##
##....  $#$ #
##....      #
##...#$###$ #
##....      #
#############
