##########
###  #####
## $..####
##  $.####
##..$.####
##$.$ ####
# $.$... #
#  @$.#$ #
# $.$  $ #
## .$$$$##
## ..   ##
##########
