###################
#      #          #
#    #   ##### #$ #
# #  ### #   #  $ #
# #        #  $$$ #
#   #  ### #  $ # #
##  $$        $ # #
## $# $   #  ## # #
##  $$ # ##     # #
#####       ### # #
##   ##         # #
#  .     ######  ##
#  .##  #......# ##
#...##           ##
#.#####  ####  ####
#+#################
###################
