##########
####   ###
####$$  ##
###  .$ ##
#   *$* ##
#  * @ *##
##  * * ##
## $ *  ##
#######  #
###....  #
##########
