########
#    ###
# * $ .#
# $*** #
#  *@* #
#  *** #
##. $ .#
##    ##
####   #
########
