###################
##             ####
#  ###$$$##### ####
# $###   ### # ####
#    #$# $ # # ####
# $#$#     # # ####
#    $ $ ##### ####
####$ ## ##.......#
##        #.......#
## $# #####  ######
##  $$#####  ######
####@        ######
##########   ######
##########   ######
##########   ######
###################
