###########
##       ##
##$#####  #
#   ##### #
# $.$   # #
# # ..# # #
# $$... # #
# @$..# # #
# $.$ # # #
# #$### # #
#       # #
# ####### #
#         #
###########
