###################
##         ########
#  ###$$$# ########
# $###   # ########
#    #$# $ ########
# $#$#   # ########
#    $ $ # ########
####$ ## # .......#
##         .......#
## $# ####  #######
##  $$#############
####@ #############
###################
