############
##     #####
# ...   ####
# .#. $  ###
# ... #  ###
##### #  ###
#####$#$ $ #
#####@#  $ #
#######$   #
#### $ $  ##
####      ##
############
