#################
#  #      #######
#  # #### #######
#  #    . #######
##     . .#######
#   # . ##.######
#   #.     .#####
#   . # ##  .####
#  . #  $    .  #
# . #  $#$  # . #
#  #  $ # $#    #
# #  $  #  $   ##
##  $  ###  $   #
## $  #####  $  #
# $  #######  $ #
#@  #########   #
#################
