#######
##@####
##   ##
#  *  #
# * * #
#  .  #
# *** #
#  $  #
# * * #
#  *  #
#     #
#### ##
#######
