############
####   #####
#### $  ####
##### $  ###
###### $  ##
####### $  #
#.    ## $ #
##.        #
###.  ######
####.@######
#####.######
############
