#################
# @#####        #
# $####  ###### #
#  ###   #..... #
# $### ###..... #
#   #  #..   #  #
# $$# #...   # ##
#   #$##    ##$##
#   #  #    #  ##
### # $ #  ## ###
### #  $ # ## ###
### #   $  ## ###
#   $ $ $  $  ###
##             ##
#########  $ $ ##
#########  ######
#################
