###################
###  ##############
### $##############
##   ######       #
## $ #####  $ $ $ #
##   ####  ## # # #
## $$###..  $ $ $ #
#### #.#..#. ######
####   ....   #####
#     .#..#.  #####
# ### # .. #   ####
#   $ $ $#$$$  ####
###          ######
##### @############
###################
