###########
#     #  ##
# .$. $   #
# $.$ $ #@#
# .$. $   #
#  .  #  ##
# .$. # ###
# $.$  ####
# .$.  ####
#     #####
###########
