#################
#...#           #
#... # #######  #
#. . #          #
### #    ###   ##
#       #   #  ##
# #    ## $  # ##
#  ##### $ $ # ##
#        $@$ # ##
#  ### # $ $ # ##
#  # #  # $ ## ##
#  # ## #   ## ##
#  #### ###### ##
#  #           ##
#     #######  ##
# #   #######  ##
#################
