##############
#  #      ####
#  # #### ####
#  #    . ####
##     .  ####
#   # . ######
#   #.      ##
#   . # ##   #
#  . #  $    #
# . #  $##  ##
#  #  $ ######
# #  $  ######
##  $  #######
## $  ########
# $  #########
#@  ##########
##############
