##############
########   ###
######## $ ###
##  ##       #
##     #.....#
##  ##    #..#
###$# $ #    #
#     # ######
#  $$$$ ######
##  @ # ######
#####   ######
##############
