##############
##    ########
## $$ ########
#  $   #######
# $ ## ##.. ##
# $  # ##.  ##
# $$ # #.  ###
#  $$#  .# ###
#  $    ..   #
##  $$   ..  #
###      .   #
####@ ##  ..##
##############
