###############
########   ####
#######.....  #
############  #
#####    $   ##
#####   $$$  ##
######## $ # ##
#        $    #
#   ####$$$# ##
#####    $   ##
##### ######  #
#####  .....  #
#####@##   ####
###############
