################
##       #######
## ### #  ######
##        ######
#  ##    #######
#   # ##      ##
## $$ #      .##
# $$  # ###..###
#@ $    ###..###
#####  #########
#####  #########
################
