#########
#####...#
#### ...#
##   ...#
#     ###
# $$$ ###
# $@$ ###
# # $ ###
# $$$ ###
#     ###
#########
