###############
###     ###..##
##  ###  #....#
# $ #   $#...##
# $ $ $ $ ...##
#    ###$#  ###
# $#@# #   ####
#  # ###$# ####
## #$$  $  ####
##    #  ######
##### # #######
#####   #######
###############
