#############
#          ##
# $   $ $  ##
#   ##### ..#
# $ $ $@# ..#
# #     # ..#
#############
