########
##     #
#  $ $ #
#$$$$$ #
#...#  #
#.*.#$ #
##.##  #
##.##$ #
##.##@ #
##.#####
########
