###########
#     #####
# $$$ #####
# $   #####
#   $ #####
# $@  #####
#####    ##
####  #$ ##
#### $ $  #
####  $  ##
##### $ ###
##### $ ###
#####...###
#####...###
#####...###
#####...###
###########
