#############
#####   #####
##### $ #####
#####$# #####
#   $ #     #
#  $        #
# $ $  ###..#
# @ #  #....#
#############
