###############
##  ###########
#   ###########
#   $@####   .#
##  $$$ $ $ ..#
###   $ $ $#.##
##### $ $ $ .##
##### $ $ $#..#
#####       #.#
######## ####.#
#######  # ##.#
#######  ###..#
#######    ...#
############  #
###############
