###########
#         #
# $$$$$$$ #
#  $ $  $ #
##$$. +#$ #
##  ####  #
#.......$ #
#.....*.$ #
######    #
###########
