#############
#          ##
#   $ $ $ $##
#  $##### ..#
# $@$   #...#
# #     ##..#
#############
