#########
#.  .  .#
# #$.$# #
# $ * $ #
# $ + $ #
# $ . $ #
# $$$$$ #
#.......#
#########
