#######
#@    #
# $#..#
# $  .#
# $$$.#
#    .#
#######
