##############
##########.  #
##########.  #
##########.  #
##  ######. ##
##  ######. ##
#     ####.$##
# #$$$ $    ##
# $    # ## ##
# ## @#     ##
##############
