############
########   #
##         #
##    # # ##
#  # $    ##
#   $ #   ##
#  $@#   .##
# $ # $  .##
###    ...##
############
