#########
#       #
# $*$$* #
# .*..$ #
# **+.$ #
# $.$$. #
# .$..$ #
#       #
#########
