##########
#@    ####
# $#..####
# $  .####
# $$$.####
#    .####
##### #  #
####     #
#### $#..#
#### $  .#
#### $$$.#
####    .#
##########
