###########
#    ######
# $.$ ##  #
# #.$ ##  #
# #.$ ....#
# $.# ###.#
# $.# @####
# $ $ #####
# # $$#####
#     #####
###########
