###########
##     ####
## .* .  ##
##... # $##
##..  $  ##
# $  $.$  #
# . ##$   #
###$ $@$ ##
###   #####
###########
