###########
##  #######
##  $ $ ###
##  #   ###
## $### ###
#       ###
# $#$#$   #
#  #.#@## #
# $#...   #
#   ...####
###########
