#########
##### ..#
##   $..#
## $  ..#
#  #  ###
# $$$ ###
# $@ $###
# # $ ###
#  $  ###
# $ ....#
#########
