#############
#@    #######
# $#..#######
# $  .####..#
# $$$.####..#
# $  .####..#
##### #  $  #
####    $   #
#### $#$$####
####     ####
#############
