#########
#.  .  .#
# #$.$# #
# $ * $ #
# ##+## #
#  $*$  #
# $   $ #
#.  .  .#
#########
