#########
#####...#
#####...#
#####   #
# $ $ $ #
# $     #
# $$#####
# @ #####
#########
