###################
###########    ####
#########   . .####
#######    #.#.####
#####    # #.#.####
###    # # #.#.####
#    # # # ########
#  #       ########
## ################
##                #
##$#$#$#$#$#$#$#$ #
##   # # # # # #@##
####             ##
###################
