#########
###...###
### $ ###
#   $   #
#@$ $ $ #
##$ $ $##
# $ . $ #
# $ . $ #
#.......#
#########
