###############
#######    ####
#######  $ ####
###    $$ $####
###   $    . .#
##   #  #  . .#
#  # $ #  #.#.#
#   $ #   #.#.#
#  $@#    #.#.#
# $ # $   #####
###       #####
###############
