########
##     #
#  $ $ #
#$$$ $ #
#. .#  #
#...#$ #
##.##  #
##.##$ #
##.##@ #
########
