########
##     #
#  $ $ #
#$$$$$ #
#...#  #
#...#$ #
##.##  #
##.##$ #
##.##@ #
########
