##########
#  .  $ ##
# .#.$ $ #
# .#.$ $ #
# ...$@$ #
# .#.$ $ #
# .#.$ $ #
#  .  $  #
#  #$    #
#  #  ####
## # #####
##########
