##############
##########...#
######.......#
######.##..  #
####@$ ####  #
#            #
# $$$###$#$ ##
#           ##
# $$$$$$#$# ##
#           ##
##############
