#############
##     ######
## $  $ #####
#   # # #..##
# #$# # #..##
#   # # $...#
##$$$ $ $ ..#
##      @ ###
#############
