############
###      ###
# $ $..$   #
# $#$..$#$ #
#  # .. #  #
# $#....#$ #
#  # .. #  #
# $#$..$#$ #
#   $..$ $ #
###     @###
############
