##############
##........####
########..####
#      #.....#
# $$$  #     #
# $ $$ # $ ###
# $@$  # #   #
# $ $$ #     #
# $$$  # ##  #
#            #
###########  #
##############
