###################
#   ###########   #
# $$#######   #$$ #
#                 #
### ######  ### ###
### #    #  # # ###
### ######  ### ###
#   #.#      ##   #
# $$#....    ##$$@#
#   #  #.# # ##   #
#####  #.#   ######
#####   ....#######
#####  # # .#######
#                 #
# $$####   ####$$ #
#   ###########   #
###################
