###########
#.   ######
# .  #   ##
# #. # $ ##
# . $$$   #
#.#@   #$ #
# . $$$   #
# #. # $ ##
# .  #   ##
#.   ######
###########
