#############
#           #
# $$$$$$$ $ #
# $     #####
# $ $$$ #####
#  $    #####
##  $@#  ####
##   $ . ####
######...####
#####.....###
####.......##
#############
