##########
##     ###
## ### ###
##  $ @###
# $$$$   #
#  $   ..#
## $###.##
##  ....##
##########
