################
#...#######   ##
#. .        $ ##
#. .#### ###$ ##
#...#  # ## $ ##
##. ####    $ ##
##.   ##  # $ ##
##.         $  #
##.#  #### $$$ #
##.####### $ $ #
##.####### $@$ #
########## $$$ #
##########     #
################
