##############
##     #######
## $$$$ ######
#  #... #    #
# # ... #$$  #
#   ...      #
##$$$.$$$#   #
##  ..$ @#####
## .  ########
##############
