########
#   @  #
# $$$$ #
# $..$ #
# $..$ #
# $..$ #
# .... #
########
