##############
####  @  #####
#     .      #
# $$##.###$$ #
# $   .    $ #
# $ .....  $ #
#           ##
##############
