##########
#  ####  #
#        #
#  ####  #
##@##. $##
#  #.$* ##
#      ###
#  #  ####
##########
