#########
##  #  ##
# .$*$. #
#   #   #
##  *  ##
##@ *  ##
#########
