######
##  ##
##. ##
##$@ #
## * #
#  * #
#  * #
## * #
##  ##
######
