########
##  @ ##
## #   #
# .*.*.#
#  $ $ #
#####$ #
#####  #
########
