#########
###+ .###
###     #
#### $  #
####$####
## $   ##
#  . * ##
#   #  ##
#########
