##########
##   #####
##*# #####
# * $ *  #
#   . @  #
###  #*###
####   ###
##########
