########
###    #
#  *##.#
# #.  .#
# $ $  #
##$#$#@#
##    .#
########
