#######
##  ###
## *$ #
##  # #
## ** #
#   #@#
#  ** #
#   # #
## *. #
##  ###
#######
