#######
###  ##
# .* ##
# #   #
#@**  #
# #   #
# $* ##
###  ##
#######
