#########
###  ####
# $     #
# . *#  #
###.@#$##
# . *#  #
# $     #
######  #
#########
