##################
#    #     #  #  #
#     #  #       #
## #      # #    #
#    # #      # ##
#@ #    # #  # . #
##   #     #     #
#  #   #$#   # # #
#   #     # #    #
## #  # #       ##
#    #      #  # #
# #      #   #   #
#   #  #   #   # #
##################
