##################
###     #     #  #
##  ### # ### #  #
##               #
### ## #  # #  # #
#      #         #
# # # ########  ##
#       @ $  ##  #
## ## #### # .   #
##    #  #   # ###
###       #    ###
##  ### # # ##  ##
##  ##      ### ##
##     ####     ##
##################
