###################
##   #  #    #  @.#
##      # ##   # ##
##### #      #    #
#   # # # ## ##   #
#     # # ##    # #
## #  # #    #  # #
## ###    ## # ## #
## #   ## ## #    #
#          # #  ###
#  #  # ##    #   #
#  #  #    #  #   #
##### # ## ## ## ##
#   $   #        ##
#   #  ##   ###  ##
###################
