########
## .####
##    .#
##$$$$@#
## # ###
#   . ##
# .   ##
########
