#########
###   ###
### # ###
# . * ###
#  $#$###
##. * @ #
##  #   #
#########
