#########
#####   #
##  #   #
## * * ##
# *.*$@##
#  * * ##
##     ##
#########
