########
##  ####
## . $ #
#  * # #
#  $ . #
###*#@##
###   ##
########
