#########
##  #####
##  .  ##
#  $.$ ##
# $*#*@ #
## .$.  #
##  #####
##  #####
#########
