########
###  ###
###  ###
#  $$$ #
# ...# #
# #... #
# $$$@##
###   ##
########
