########
###  ###
# * $  #
# *.@* #
# *  # #
# ##*# #
#      #
########
