###########
#.  #######
#..    ####
#. # # ####
##    $  ##
####  $$$@#
#######   #
###########
