###########
#  $. .$  #
#  $*@*$  #
### .#. ###
###     ###
###########
