#######
#  ####
# .  .#
# . # #
#  $  #
##$$###
## @###
#######
