#########
#   #####
#    ####
##   $ ##
##*#$#+##
# .  $. #
#   #   #
#########
