########
###  ###
###  $ #
# ...@ #
# $# $ #
# $..$##
#  #  ##
########
