########
##  ####
##   ###
#  $  ##
#.#*#*##
#  @   #
#  #   #
########
