#######
###  ##
#  $  #
#@.*. #
## $  #
####  #
#######
