#########
#   #####
#  .$ ###
## .# $ #
## .# $@#
###.  $ #
###  ####
#########
