##########
##  #  ###
# $ # $  #
#  .@.   #
##$ # $###
## . . ###
##########
