######
#   ##
#.#$##
#  @ #
#. $ #
###  #
######
