#######
##...##
# $$$.#
# $+$ #
#.$$$ #
##..  #
#######
