########
##  ####
#      #
# ..#$ #
###  $ #
#####@ #
########
