########
####   #
####   #
#.*   ##
# $#  ##
#@ #  ##
########
