#########
##  #####
##$@#####
##.$#####
##.$  ###
# .#   ##
#       #
#####   #
#########
