#######
#  ####
# @  ##
#. #$##
##.$  #
# $.# #
# #   #
#    ##
###  ##
#######
