########
###  ###
#    ###
#   .###
### #@.#
### $$ #
###  $ #
###. ###
########
