#########
#  ######
#    @ ##
# .*.$* #
##  #$  #
###   ###
#########
