#########
##  ## .#
##   $  #
#  $#$ .#
#   #@ ##
#. ##  ##
#########
