########
## .   #
# $*$# #
# #@   #
#  . ###
########
