########
#  #####
#  .*. #
# $ $ @#
#   ####
########
