#######
###  ##
#    ##
# # ..#
# $$$@#
### # #
###  .#
#######
