########
###   ##
###$# ##
#  $@$ #
# #    #
#... ###
########
