######
#.@###
#  ###
# $  #
# $. #
#  ###
######
