#######
##  ###
##   ##
# @$$ #
# # # #
#..   #
#######
