######
#  ###
#  ###
#  $ #
##*#.#
#  @ #
#    #
#  ###
######
