########
##  ####
# .$$  #
# .@.  #
# $$. ##
###  ###
########
