#########
###  ####
###    ##
## $.$ ##
# .***. #
#  $.$  #
### @ ###
###  ####
#########
