##########
####  ####
###  *   #
###@*.*  #
#  * $ * #
#   ##  ##
######  ##
##########
