#########
##   ####
## *.* ##
#  $*$  #
#  *.*  #
### @  ##
###  ####
#########
