########
###@  ##
###.   #
# $*$  #
#  . ###
## * ###
##  ####
########
