########
###  ###
###  ###
# $$ ###
#. .$. #
# .*.  #
##$ $###
## @ ###
########
