#########
#####  ##
#  ##  ##
#   $*.##
#  #*@*##
##  .*$ #
### #   #
###   ###
#########
