#########
##   ####
##*$@####
# .*$   #
#  .*$  #
## #. ###
##    ###
#########
