########
## . ###
## $  ##
# * * ##
# ***  #
#  @   #
########
