#######
##    #
##$$@ #
##..###
##.*  #
#  $  #
#  # ##
##   ##
#######
