##########
### @#####
## $$$.###
#  .$..###
#  ..$.  #
###.$$$  #
###   ####
##########
