###########
#  ########
#    $   ##
#  **.**  #
#   *@*   #
###########
