########
###  ###
###. ###
## . ###
##$.$###
#@$.$  #
# $.   #
###  ###
########
