########
#   ####
#   ####
#*+*####
#   ####
#*$*####
#      #
#  #   #
########
