##########
##  ######
##       #
## $@#$# #
##.*..*. #
#  *  * ##
# #$##$###
#      ###
##########
