########
#  #  ##
#  #   #
# .*$# #
#  *@  #
# .*$###
## # ###
##   ###
########
