#######
## @###
##  ###
##$$###
#     #
# #   #
#.*.*##
##   ##
##  ###
#######
