#########
####  ###
## $$ ###
# ....  #
#  $$   #
### @####
#########
