#######
###. ##
# $ .##
# # ..#
# @ # #
# $$$ #
##   ##
##  ###
#######
