########
####   #
#@$  # #
# $$$  #
##.#.  #
#  ..# #
#  #.* #
# $.$ ##
###   ##
########
