##########
#  #######
#        #
#  ###$# #
##.# # . #
## # #$* #
##.### + #
## $ #$* #
## #   . #
##.####* #
#  $ $ * #
#       ##
##########
