#########
###   ###
# $*@.###
# # *$  #
# #. .# #
# #$* $ #
#    .###
###   ###
#########
