##########
##       #
## $ ### #
##  $  # #
####*$ # #
#.  .  # #
#.** ### #
#   *..$ #
###  *####
####  $@##
#####   ##
##########
