##########
###     ##
##  ###  #
## # + # #
#  #$* # #
# ## *   #
# #  *  ##
# #  * ###
# #  *####
#  # *   #
## # #  *#
## #   # #
##  ###  #
###     ##
##########
