#############
#@  . . . . #
# #.# # #*# #
# # $ # $ # #
# $ # $ # $ #
# # $ # $ # #
# $ # $ # $ #
# #*# # #.# #
# . . . .   #
#############
