###########
#      ####
# ** *  * #
# *  *  *@#
# * ##**###
#  *  $ ###
####   .###
###########
