###########
####  #####
#        ##
#.$***** ##
#   @# * ##
###### * ##
###### *  #
######    #
######   ##
###########
