########
#     ##
#.****##
#      #
####   #
####$$.#
####@ ##
########
