#############
#####  @#####
##### $$#####
####   $  ###
#### $$$$  ##
##### ..## ##
#   ##...# ##
#    $..#  ##
##$###..## ##
#    $..  $ #
#   #####   #
#############
