########
####   #
#    # #
# $*.  #
#  *@###
##$*.###
##   ###
########
