#########
####   ##
##  .#  #
#  #* # #
# $*@*$ #
#  #*   #
##  .   #
#########
