########
####  ##
#  ... #
# $.$. #
##$$$ ##
## @  ##
########
