#########
#####   #
##      #
## # # ##
##.$ $.##
# .$#$.##
# @ #  ##
#  ######
#########
