#######
##  ###
##  ###
##.   #
#. *# #
# *@$ #
## $ ##
###  ##
#######
