########
#    ###
#  #.  #
#  $*$ #
# .*.# #
###$ @ #
###  ###
########
