########
##     #
#@*.*  #
# $ $###
# *.* ##
##    ##
##   ###
########
