#######
#  #  #
#  $  #
# .*. #
# $*$ #
## .@##
#######
