########
###  ###
###    #
#  *.# #
#  $*  #
### @###
###  ###
########
