########
#    ###
# ## ###
# # . ##
# #$.$@#
#  $.$ #
##  .###
##   ###
########
