#######
#  .  #
# $*$ #
#@. .##
# $*$ #
## .  #
##  ###
#######
