#########
##  #  ##
## *$  ##
# .*@*. #
#  #$*  #
#  #  ###
##    ###
#########
