#######
#  ####
#  $. #
#  $. #
#  $. #
###$.##
###@ ##
#######
