#########
#####   #
##      #
## #$.# #
#   *** #
#   #.$##
#####@ ##
#####  ##
#########
