#########
###   ###
# $**.  #
#@$  .# #
# $ #.  #
###   ###
#########
