#########
#### .  #
###  *  #
# $**$  #
#@*  # ##
##.#   ##
##   ####
#########
