########
#   ####
#      #
#.*$*  #
# @#  ##
#.*$* ##
#  #  ##
########
