########
## .@###
# .*$###
#.*$   #
#*$  # #
#  ### #
#      #
#  #####
########
