########
#   ####
#     ##
##**$ ##
#  .*  #
# # ** #
#  @  ##
########
