########
##     #
#  #*# #
# **@* #
#  #*  #
# *  $.#
#  ##  #
#####  #
########
