##########
###    ###
###     ##
###$**#.##
#   .*  ##
# ## **$##
# #@*    #
# #* * . #
# # * # ##
# #$ *# ##
#     # ##
##### # ##
#####   ##
##########
