##########
#      ###
# #### ###
# #  # ###
# #  # ###
#  ..... #
## $$$$$ #
####@# ###
####   ###
##########
