#############
##      #####
## ####     #
## # @# ### #
## #***   # #
#       # #*#
#  ***##  $ #
## #     *. #
## ### ###  #
##     ######
#############
