###########
####  #####
####.$#####
####.  ####
### .#*   #
#   . *   #
#  $$$$#.##
##  #   @##
##  #######
###########
