###########
#    @    #
# ####### #
# #     # #
# #$. .$# #
# #.$ $.# #
#  $.$.$  #
###.$.$.###
###     ###
###########
