############
######     #
###    ### #
### * #  # #
#  #$.# *  #
# *$@*   ###
#  .*#   ###
####   #####
############
