#############################
#                   #########
# ################# #########
# #               # #########
# # ############# # #########
# # #           # # #########
# # # ######### # # #########
# # # #       # # # #       #
# # # # ##### # # # # ##### #
# # # # #@  # # # # # #   # #
# # # # # # ..... $$$$$ # # #
# # # # #   $$$$$ .....   # #
# # # # ##### # # # # ##### #
# # # #       # # # #       #
# # # ######### # # #########
# # #           # # #########
# # ############# # #########
# #               # #########
# ################# #########
#                   #########
#############################
