#################
#           #####
# ######### #####
# #       # #####
# # ##### # #####
# # #   # # #####
#@# # # .$.$.   #
# # #   $.$.$   #
# # ##### # #####
# #       # #####
# ######### #####
#           #####
#################
