###########
#       ###
# ##### ###
# #   # ###
# # # # ###
# ... $$$@#
# $$$ ... #
## # # # ##
## #   # ##
## ##### ##
##       ##
###########
