#############################
#               #############
# ############# #############
# #           # #           #
# # ######### # # ######### #
# # #       # # # #       # #
# # # ##### # # # # ##### # #
# # # #   # # # # # #   # # #
# # # # # # # # # # # # # # #
# # # # @   ....$$$$    # # #
# # # ##### $$$$....##### # #
# # #       # # # #       # #
# # ######### # # ######### #
# #           # #           #
# ############# #############
#               #############
#############################
